Model;Index;Size;InternalDiversity;NewShapes;AllCurrentShapes
.\measurementA\cypher\run\12_1.cypher;1;x;56;56;56
.\measurementA\cypher\run\12_2.cypher;2;x;58;15;71
.\measurementA\cypher\run\12_3.cypher;3;x;55;5;76
.\measurementA\cypher\run\12_4.cypher;4;x;56;6;82
.\measurementA\cypher\run\12_5.cypher;5;x;58;9;91
.\measurementA\cypher\run\12_6.cypher;6;x;58;2;93
.\measurementA\cypher\run\12_7.cypher;7;x;59;8;101
.\measurementA\cypher\run\12_8.cypher;8;x;58;9;110
.\measurementA\cypher\run\12_9.cypher;9;x;57;5;115
.\measurementA\cypher\run\12_10.cypher;10;x;56;6;121
.\measurementA\cypher\run\12_11.cypher;11;x;57;0;121
.\measurementA\cypher\run\12_12.cypher;12;x;56;0;121
.\measurementA\cypher\run\12_13.cypher;13;x;59;0;121
.\measurementA\cypher\run\12_14.cypher;14;x;58;0;121
.\measurementA\cypher\run\12_15.cypher;15;x;59;3;124
.\measurementA\cypher\run\12_16.cypher;16;x;57;3;127
.\measurementA\cypher\run\12_17.cypher;17;x;60;14;141
.\measurementA\cypher\run\12_18.cypher;18;x;62;1;142
.\measurementA\cypher\run\12_19.cypher;19;x;61;1;143
.\measurementA\cypher\run\12_20.cypher;20;x;63;0;143
.\measurementA\cypher\run\12_21.cypher;21;x;63;9;152
.\measurementA\cypher\run\12_22.cypher;22;x;61;4;156
.\measurementA\cypher\run\12_23.cypher;23;x;61;12;168
.\measurementA\cypher\run\12_24.cypher;24;x;63;8;176
.\measurementA\cypher\run\12_25.cypher;25;x;59;5;181
.\measurementA\cypher\run\12_26.cypher;26;x;60;0;181
.\measurementA\cypher\run\12_27.cypher;27;x;61;1;182
.\measurementA\cypher\run\12_28.cypher;28;x;62;1;183
.\measurementA\cypher\run\12_29.cypher;29;x;61;2;185
.\measurementA\cypher\run\12_30.cypher;30;x;63;1;186
.\measurementA\cypher\run\12_31.cypher;31;x;59;0;186
.\measurementA\cypher\run\12_32.cypher;32;x;61;0;186
.\measurementA\cypher\run\12_33.cypher;33;x;60;0;186
.\measurementA\cypher\run\12_34.cypher;34;x;62;0;186
.\measurementA\cypher\run\12_35.cypher;35;x;61;0;186
.\measurementA\cypher\run\12_36.cypher;36;x;60;0;186
.\measurementA\cypher\run\12_37.cypher;37;x;60;1;187
.\measurementA\cypher\run\12_38.cypher;38;x;62;0;187
.\measurementA\cypher\run\12_39.cypher;39;x;63;0;187
.\measurementA\cypher\run\12_40.cypher;40;x;61;0;187
.\measurementA\cypher\run\12_41.cypher;41;x;63;0;187
.\measurementA\cypher\run\12_42.cypher;42;x;63;7;194
.\measurementA\cypher\run\12_43.cypher;43;x;61;5;199
.\measurementA\cypher\run\12_44.cypher;44;x;63;1;200
.\measurementA\cypher\run\12_45.cypher;45;x;63;2;202
.\measurementA\cypher\run\12_46.cypher;46;x;62;0;202
.\measurementA\cypher\run\12_47.cypher;47;x;61;2;204
.\measurementA\cypher\run\12_48.cypher;48;x;63;1;205
.\measurementA\cypher\run\12_49.cypher;49;x;61;0;205
.\measurementA\cypher\run\12_50.cypher;50;x;63;0;205
Model;Index;Size;InternalDiversity;NewShapes;AllCurrentShapes
.\measurementA\cypher\run1\1_1.cypher;1;x;57;57;57
.\measurementA\cypher\run1\1_2.cypher;2;x;57;12;69
.\measurementA\cypher\run1\1_3.cypher;3;x;59;16;85
.\measurementA\cypher\run1\1_4.cypher;4;x;58;0;85
.\measurementA\cypher\run1\1_5.cypher;5;x;58;0;85
.\measurementA\cypher\run1\1_6.cypher;6;x;56;5;90
.\measurementA\cypher\run1\1_7.cypher;7;x;59;6;96
.\measurementA\cypher\run1\1_8.cypher;8;x;56;0;96
.\measurementA\cypher\run1\1_9.cypher;9;x;57;5;101
.\measurementA\cypher\run1\1_10.cypher;10;x;60;0;101
.\measurementA\cypher\run1\1_11.cypher;11;x;60;0;101
.\measurementA\cypher\run1\1_12.cypher;12;x;57;0;101
.\measurementA\cypher\run1\1_13.cypher;13;x;58;6;107
.\measurementA\cypher\run1\1_14.cypher;14;x;58;0;107
.\measurementA\cypher\run1\1_15.cypher;15;x;59;4;111
.\measurementA\cypher\run1\1_16.cypher;16;x;59;0;111
.\measurementA\cypher\run1\1_17.cypher;17;x;57;10;121
.\measurementA\cypher\run1\1_18.cypher;18;x;57;7;128
.\measurementA\cypher\run1\1_19.cypher;19;x;59;6;134
.\measurementA\cypher\run1\1_20.cypher;20;x;58;0;134
.\measurementA\cypher\run1\1_21.cypher;21;x;59;8;142
.\measurementA\cypher\run1\1_22.cypher;22;x;56;0;142
.\measurementA\cypher\run1\1_23.cypher;23;x;57;0;142
.\measurementA\cypher\run1\1_24.cypher;24;x;56;0;142
.\measurementA\cypher\run1\1_25.cypher;25;x;58;0;142
.\measurementA\cypher\run1\1_26.cypher;26;x;58;0;142
.\measurementA\cypher\run1\1_27.cypher;27;x;57;0;142
.\measurementA\cypher\run1\1_28.cypher;28;x;59;0;142
.\measurementA\cypher\run1\1_29.cypher;29;x;60;0;142
.\measurementA\cypher\run1\1_30.cypher;30;x;59;0;142
.\measurementA\cypher\run1\1_31.cypher;31;x;57;0;142
.\measurementA\cypher\run1\1_32.cypher;32;x;59;0;142
.\measurementA\cypher\run1\1_33.cypher;33;x;58;7;149
.\measurementA\cypher\run1\1_34.cypher;34;x;59;0;149
.\measurementA\cypher\run1\1_35.cypher;35;x;58;0;149
.\measurementA\cypher\run1\1_36.cypher;36;x;57;0;149
.\measurementA\cypher\run1\1_37.cypher;37;x;58;0;149
.\measurementA\cypher\run1\1_38.cypher;38;x;60;4;153
.\measurementA\cypher\run1\1_39.cypher;39;x;60;0;153
.\measurementA\cypher\run1\1_40.cypher;40;x;61;0;153
.\measurementA\cypher\run1\1_41.cypher;41;x;58;1;154
.\measurementA\cypher\run1\1_42.cypher;42;x;58;0;154
.\measurementA\cypher\run1\1_43.cypher;43;x;59;0;154
.\measurementA\cypher\run1\1_44.cypher;44;x;60;0;154
.\measurementA\cypher\run1\1_45.cypher;45;x;58;0;154
.\measurementA\cypher\run1\1_46.cypher;46;x;58;0;154
.\measurementA\cypher\run1\1_47.cypher;47;x;57;0;154
.\measurementA\cypher\run1\1_48.cypher;48;x;60;0;154
.\measurementA\cypher\run1\1_49.cypher;49;x;57;0;154
.\measurementA\cypher\run1\1_50.cypher;50;x;59;0;154
Model;Index;Size;InternalDiversity;NewShapes;AllCurrentShapes
.\measurementA\cypher\run10\10_1.cypher;1;x;56;56;56
.\measurementA\cypher\run10\10_2.cypher;2;x;57;15;71
.\measurementA\cypher\run10\10_3.cypher;3;x;56;0;71
.\measurementA\cypher\run10\10_4.cypher;4;x;55;0;71
.\measurementA\cypher\run10\10_5.cypher;5;x;58;15;86
.\measurementA\cypher\run10\10_6.cypher;6;x;59;9;95
.\measurementA\cypher\run10\10_7.cypher;7;x;60;11;106
.\measurementA\cypher\run10\10_8.cypher;8;x;57;7;113
.\measurementA\cypher\run10\10_9.cypher;9;x;56;5;118
.\measurementA\cypher\run10\10_10.cypher;10;x;58;0;118
.\measurementA\cypher\run10\10_11.cypher;11;x;57;0;118
.\measurementA\cypher\run10\10_12.cypher;12;x;57;0;118
.\measurementA\cypher\run10\10_13.cypher;13;x;56;0;118
.\measurementA\cypher\run10\10_14.cypher;14;x;58;0;118
.\measurementA\cypher\run10\10_15.cypher;15;x;57;0;118
.\measurementA\cypher\run10\10_16.cypher;16;x;57;0;118
.\measurementA\cypher\run10\10_17.cypher;17;x;59;1;119
.\measurementA\cypher\run10\10_18.cypher;18;x;58;6;125
.\measurementA\cypher\run10\10_19.cypher;19;x;59;0;125
.\measurementA\cypher\run10\10_20.cypher;20;x;57;3;128
.\measurementA\cypher\run10\10_21.cypher;21;x;59;0;128
.\measurementA\cypher\run10\10_22.cypher;22;x;58;0;128
.\measurementA\cypher\run10\10_23.cypher;23;x;59;3;131
.\measurementA\cypher\run10\10_24.cypher;24;x;59;0;131
.\measurementA\cypher\run10\10_25.cypher;25;x;60;14;145
.\measurementA\cypher\run10\10_26.cypher;26;x;62;0;145
.\measurementA\cypher\run10\10_27.cypher;27;x;61;0;145
.\measurementA\cypher\run10\10_28.cypher;28;x;59;0;145
.\measurementA\cypher\run10\10_29.cypher;29;x;60;5;150
.\measurementA\cypher\run10\10_30.cypher;30;x;60;6;156
.\measurementA\cypher\run10\10_31.cypher;31;x;62;2;158
.\measurementA\cypher\run10\10_32.cypher;32;x;59;0;158
.\measurementA\cypher\run10\10_33.cypher;33;x;61;0;158
.\measurementA\cypher\run10\10_34.cypher;34;x;60;0;158
.\measurementA\cypher\run10\10_35.cypher;35;x;62;0;158
.\measurementA\cypher\run10\10_36.cypher;36;x;62;3;161
.\measurementA\cypher\run10\10_37.cypher;37;x;60;13;174
.\measurementA\cypher\run10\10_38.cypher;38;x;62;0;174
.\measurementA\cypher\run10\10_39.cypher;39;x;60;0;174
.\measurementA\cypher\run10\10_40.cypher;40;x;62;9;183
.\measurementA\cypher\run10\10_41.cypher;41;x;62;4;187
.\measurementA\cypher\run10\10_42.cypher;42;x;61;0;187
.\measurementA\cypher\run10\10_43.cypher;43;x;62;0;187
.\measurementA\cypher\run10\10_44.cypher;44;x;61;0;187
.\measurementA\cypher\run10\10_45.cypher;45;x;63;2;189
.\measurementA\cypher\run10\10_46.cypher;46;x;62;0;189
.\measurementA\cypher\run10\10_47.cypher;47;x;62;0;189
.\measurementA\cypher\run10\10_48.cypher;48;x;62;0;189
.\measurementA\cypher\run10\10_49.cypher;49;x;63;1;190
.\measurementA\cypher\run10\10_50.cypher;50;x;63;0;190
Model;Index;Size;InternalDiversity;NewShapes;AllCurrentShapes
.\measurementA\cypher\run2\2_1.cypher;1;x;55;55;55
.\measurementA\cypher\run2\2_2.cypher;2;x;53;5;60
.\measurementA\cypher\run2\2_3.cypher;3;x;55;9;69
.\measurementA\cypher\run2\2_4.cypher;4;x;56;13;82
.\measurementA\cypher\run2\2_5.cypher;5;x;58;3;85
.\measurementA\cypher\run2\2_6.cypher;6;x;57;7;92
.\measurementA\cypher\run2\2_7.cypher;7;x;59;1;93
.\measurementA\cypher\run2\2_8.cypher;8;x;58;12;105
.\measurementA\cypher\run2\2_9.cypher;9;x;62;3;108
.\measurementA\cypher\run2\2_10.cypher;10;x;62;5;113
.\measurementA\cypher\run2\2_11.cypher;11;x;62;8;121
.\measurementA\cypher\run2\2_12.cypher;12;x;65;8;129
.\measurementA\cypher\run2\2_13.cypher;13;x;65;1;130
.\measurementA\cypher\run2\2_14.cypher;14;x;65;5;135
.\measurementA\cypher\run2\2_15.cypher;15;x;63;7;142
.\measurementA\cypher\run2\2_16.cypher;16;x;63;0;142
.\measurementA\cypher\run2\2_17.cypher;17;x;63;0;142
.\measurementA\cypher\run2\2_18.cypher;18;x;63;0;142
.\measurementA\cypher\run2\2_19.cypher;19;x;63;4;146
.\measurementA\cypher\run2\2_20.cypher;20;x;63;1;147
.\measurementA\cypher\run2\2_21.cypher;21;x;63;0;147
.\measurementA\cypher\run2\2_22.cypher;22;x;63;0;147
.\measurementA\cypher\run2\2_23.cypher;23;x;63;4;151
.\measurementA\cypher\run2\2_24.cypher;24;x;63;2;153
.\measurementA\cypher\run2\2_25.cypher;25;x;63;4;157
.\measurementA\cypher\run2\2_26.cypher;26;x;63;2;159
.\measurementA\cypher\run2\2_27.cypher;27;x;62;4;163
.\measurementA\cypher\run2\2_28.cypher;28;x;62;0;163
.\measurementA\cypher\run2\2_29.cypher;29;x;57;1;164
.\measurementA\cypher\run2\2_30.cypher;30;x;59;0;164
.\measurementA\cypher\run2\2_31.cypher;31;x;59;0;164
.\measurementA\cypher\run2\2_32.cypher;32;x;59;0;164
.\measurementA\cypher\run2\2_33.cypher;33;x;58;1;165
.\measurementA\cypher\run2\2_34.cypher;34;x;60;0;165
.\measurementA\cypher\run2\2_35.cypher;35;x;60;0;165
.\measurementA\cypher\run2\2_36.cypher;36;x;60;0;165
.\measurementA\cypher\run2\2_37.cypher;37;x;58;2;167
.\measurementA\cypher\run2\2_38.cypher;38;x;60;1;168
.\measurementA\cypher\run2\2_39.cypher;39;x;60;0;168
.\measurementA\cypher\run2\2_40.cypher;40;x;60;2;170
.\measurementA\cypher\run2\2_41.cypher;41;x;58;1;171
.\measurementA\cypher\run2\2_42.cypher;42;x;60;0;171
.\measurementA\cypher\run2\2_43.cypher;43;x;60;0;171
.\measurementA\cypher\run2\2_44.cypher;44;x;60;0;171
.\measurementA\cypher\run2\2_45.cypher;45;x;60;2;173
.\measurementA\cypher\run2\2_46.cypher;46;x;60;2;175
.\measurementA\cypher\run2\2_47.cypher;47;x;58;1;176
.\measurementA\cypher\run2\2_48.cypher;48;x;60;0;176
.\measurementA\cypher\run2\2_49.cypher;49;x;63;0;176
.\measurementA\cypher\run2\2_50.cypher;50;x;63;0;176
Model;Index;Size;InternalDiversity;NewShapes;AllCurrentShapes
.\measurementA\cypher\run3\3_1.cypher;1;x;58;58;58
.\measurementA\cypher\run3\3_2.cypher;2;x;58;0;58
.\measurementA\cypher\run3\3_3.cypher;3;x;59;11;69
.\measurementA\cypher\run3\3_4.cypher;4;x;59;0;69
.\measurementA\cypher\run3\3_5.cypher;5;x;58;6;75
.\measurementA\cypher\run3\3_6.cypher;6;x;58;0;75
.\measurementA\cypher\run3\3_7.cypher;7;x;59;5;80
.\measurementA\cypher\run3\3_8.cypher;8;x;59;0;80
.\measurementA\cypher\run3\3_9.cypher;9;x;63;17;97
.\measurementA\cypher\run3\3_10.cypher;10;x;63;12;109
.\measurementA\cypher\run3\3_11.cypher;11;x;63;13;122
.\measurementA\cypher\run3\3_12.cypher;12;x;63;0;122
.\measurementA\cypher\run3\3_13.cypher;13;x;63;0;122
.\measurementA\cypher\run3\3_14.cypher;14;x;63;0;122
.\measurementA\cypher\run3\3_15.cypher;15;x;67;10;132
.\measurementA\cypher\run3\3_16.cypher;16;x;67;5;137
.\measurementA\cypher\run3\3_17.cypher;17;x;67;6;143
.\measurementA\cypher\run3\3_18.cypher;18;x;67;7;150
.\measurementA\cypher\run3\3_19.cypher;19;x;66;4;154
.\measurementA\cypher\run3\3_20.cypher;20;x;66;2;156
.\measurementA\cypher\run3\3_21.cypher;21;x;66;2;158
.\measurementA\cypher\run3\3_22.cypher;22;x;69;21;179
.\measurementA\cypher\run3\3_23.cypher;23;x;69;4;183
.\measurementA\cypher\run3\3_24.cypher;24;x;71;3;186
.\measurementA\cypher\run3\3_25.cypher;25;x;67;6;192
.\measurementA\cypher\run3\3_26.cypher;26;x;65;1;193
.\measurementA\cypher\run3\3_27.cypher;27;x;64;7;200
.\measurementA\cypher\run3\3_28.cypher;28;x;64;0;200
.\measurementA\cypher\run3\3_29.cypher;29;x;64;4;204
.\measurementA\cypher\run3\3_30.cypher;30;x;64;0;204
.\measurementA\cypher\run3\3_31.cypher;31;x;64;4;208
.\measurementA\cypher\run3\3_32.cypher;32;x;64;0;208
.\measurementA\cypher\run3\3_33.cypher;33;x;64;4;212
.\measurementA\cypher\run3\3_34.cypher;34;x;64;2;214
.\measurementA\cypher\run3\3_35.cypher;35;x;63;4;218
.\measurementA\cypher\run3\3_36.cypher;36;x;63;2;220
.\measurementA\cypher\run3\3_37.cypher;37;x;67;0;220
.\measurementA\cypher\run3\3_38.cypher;38;x;67;1;221
.\measurementA\cypher\run3\3_39.cypher;39;x;67;0;221
.\measurementA\cypher\run3\3_40.cypher;40;x;67;0;221
.\measurementA\cypher\run3\3_41.cypher;41;x;67;0;221
.\measurementA\cypher\run3\3_42.cypher;42;x;67;0;221
.\measurementA\cypher\run3\3_43.cypher;43;x;67;1;222
.\measurementA\cypher\run3\3_44.cypher;44;x;67;0;222
.\measurementA\cypher\run3\3_45.cypher;45;x;67;0;222
.\measurementA\cypher\run3\3_46.cypher;46;x;71;3;225
.\measurementA\cypher\run3\3_47.cypher;47;x;71;0;225
.\measurementA\cypher\run3\3_48.cypher;48;x;64;0;225
.\measurementA\cypher\run3\3_49.cypher;49;x;68;1;226
.\measurementA\cypher\run3\3_50.cypher;50;x;64;0;226
Model;Index;Size;InternalDiversity;NewShapes;AllCurrentShapes
.\measurementA\cypher\run4\4_1.cypher;1;x;52;52;52
.\measurementA\cypher\run4\4_2.cypher;2;x;52;11;63
.\measurementA\cypher\run4\4_3.cypher;3;x;52;0;63
.\measurementA\cypher\run4\4_4.cypher;4;x;52;0;63
.\measurementA\cypher\run4\4_5.cypher;5;x;52;0;63
.\measurementA\cypher\run4\4_6.cypher;6;x;54;16;79
.\measurementA\cypher\run4\4_7.cypher;7;x;53;3;82
.\measurementA\cypher\run4\4_8.cypher;8;x;54;0;82
.\measurementA\cypher\run4\4_9.cypher;9;x;52;0;82
.\measurementA\cypher\run4\4_10.cypher;10;x;52;0;82
.\measurementA\cypher\run4\4_11.cypher;11;x;52;0;82
.\measurementA\cypher\run4\4_12.cypher;12;x;52;8;90
.\measurementA\cypher\run4\4_13.cypher;13;x;51;5;95
.\measurementA\cypher\run4\4_14.cypher;14;x;54;6;101
.\measurementA\cypher\run4\4_15.cypher;15;x;53;1;102
.\measurementA\cypher\run4\4_16.cypher;16;x;54;0;102
.\measurementA\cypher\run4\4_17.cypher;17;x;52;0;102
.\measurementA\cypher\run4\4_18.cypher;18;x;53;0;102
.\measurementA\cypher\run4\4_19.cypher;19;x;53;0;102
.\measurementA\cypher\run4\4_20.cypher;20;x;54;0;102
.\measurementA\cypher\run4\4_21.cypher;21;x;52;0;102
.\measurementA\cypher\run4\4_22.cypher;22;x;51;0;102
.\measurementA\cypher\run4\4_23.cypher;23;x;53;0;102
.\measurementA\cypher\run4\4_24.cypher;24;x;55;7;109
.\measurementA\cypher\run4\4_25.cypher;25;x;53;8;117
.\measurementA\cypher\run4\4_26.cypher;26;x;52;0;117
.\measurementA\cypher\run4\4_27.cypher;27;x;53;0;117
.\measurementA\cypher\run4\4_28.cypher;28;x;54;0;117
.\measurementA\cypher\run4\4_29.cypher;29;x;52;1;118
.\measurementA\cypher\run4\4_30.cypher;30;x;53;0;118
.\measurementA\cypher\run4\4_31.cypher;31;x;54;0;118
.\measurementA\cypher\run4\4_32.cypher;32;x;52;0;118
.\measurementA\cypher\run4\4_33.cypher;33;x;52;0;118
.\measurementA\cypher\run4\4_34.cypher;34;x;51;0;118
.\measurementA\cypher\run4\4_35.cypher;35;x;52;0;118
.\measurementA\cypher\run4\4_36.cypher;36;x;54;0;118
.\measurementA\cypher\run4\4_37.cypher;37;x;55;0;118
.\measurementA\cypher\run4\4_38.cypher;38;x;52;0;118
.\measurementA\cypher\run4\4_39.cypher;39;x;53;7;125
.\measurementA\cypher\run4\4_40.cypher;40;x;53;0;125
.\measurementA\cypher\run4\4_41.cypher;41;x;55;4;129
.\measurementA\cypher\run4\4_42.cypher;42;x;54;0;129
.\measurementA\cypher\run4\4_43.cypher;43;x;52;0;129
.\measurementA\cypher\run4\4_44.cypher;44;x;53;0;129
.\measurementA\cypher\run4\4_45.cypher;45;x;55;0;129
.\measurementA\cypher\run4\4_46.cypher;46;x;53;0;129
.\measurementA\cypher\run4\4_47.cypher;47;x;55;0;129
.\measurementA\cypher\run4\4_48.cypher;48;x;55;0;129
.\measurementA\cypher\run4\4_49.cypher;49;x;54;0;129
.\measurementA\cypher\run4\4_50.cypher;50;x;54;0;129
Model;Index;Size;InternalDiversity;NewShapes;AllCurrentShapes
.\measurementA\cypher\run5\5_1.cypher;1;x;52;52;52
.\measurementA\cypher\run5\5_2.cypher;2;x;53;14;66
.\measurementA\cypher\run5\5_3.cypher;3;x;53;10;76
.\measurementA\cypher\run5\5_4.cypher;4;x;52;0;76
.\measurementA\cypher\run5\5_5.cypher;5;x;52;0;76
.\measurementA\cypher\run5\5_6.cypher;6;x;53;0;76
.\measurementA\cypher\run5\5_7.cypher;7;x;53;0;76
.\measurementA\cypher\run5\5_8.cypher;8;x;55;6;82
.\measurementA\cypher\run5\5_9.cypher;9;x;53;0;82
.\measurementA\cypher\run5\5_10.cypher;10;x;53;0;82
.\measurementA\cypher\run5\5_11.cypher;11;x;55;0;82
.\measurementA\cypher\run5\5_12.cypher;12;x;55;0;82
.\measurementA\cypher\run5\5_13.cypher;13;x;56;21;103
.\measurementA\cypher\run5\5_14.cypher;14;x;58;2;105
.\measurementA\cypher\run5\5_15.cypher;15;x;53;7;112
.\measurementA\cypher\run5\5_16.cypher;16;x;54;2;114
.\measurementA\cypher\run5\5_17.cypher;17;x;54;0;114
.\measurementA\cypher\run5\5_18.cypher;18;x;53;5;119
.\measurementA\cypher\run5\5_19.cypher;19;x;54;0;119
.\measurementA\cypher\run5\5_20.cypher;20;x;53;0;119
.\measurementA\cypher\run5\5_21.cypher;21;x;54;4;123
.\measurementA\cypher\run5\5_22.cypher;22;x;53;0;123
.\measurementA\cypher\run5\5_23.cypher;23;x;54;0;123
.\measurementA\cypher\run5\5_24.cypher;24;x;53;0;123
.\measurementA\cypher\run5\5_25.cypher;25;x;53;0;123
.\measurementA\cypher\run5\5_26.cypher;26;x;56;2;125
.\measurementA\cypher\run5\5_27.cypher;27;x;56;0;125
.\measurementA\cypher\run5\5_28.cypher;28;x;54;1;126
.\measurementA\cypher\run5\5_29.cypher;29;x;54;0;126
.\measurementA\cypher\run5\5_30.cypher;30;x;56;0;126
.\measurementA\cypher\run5\5_31.cypher;31;x;54;0;126
.\measurementA\cypher\run5\5_32.cypher;32;x;54;0;126
.\measurementA\cypher\run5\5_33.cypher;33;x;54;0;126
.\measurementA\cypher\run5\5_34.cypher;34;x;56;0;126
.\measurementA\cypher\run5\5_35.cypher;35;x;56;0;126
.\measurementA\cypher\run5\5_36.cypher;36;x;54;0;126
.\measurementA\cypher\run5\5_37.cypher;37;x;54;0;126
.\measurementA\cypher\run5\5_38.cypher;38;x;56;0;126
.\measurementA\cypher\run5\5_39.cypher;39;x;57;0;126
.\measurementA\cypher\run5\5_40.cypher;40;x;57;0;126
.\measurementA\cypher\run5\5_41.cypher;41;x;57;0;126
.\measurementA\cypher\run5\5_42.cypher;42;x;59;1;127
.\measurementA\cypher\run5\5_43.cypher;43;x;59;0;127
.\measurementA\cypher\run5\5_44.cypher;44;x;59;0;127
.\measurementA\cypher\run5\5_45.cypher;45;x;59;0;127
.\measurementA\cypher\run5\5_46.cypher;46;x;59;0;127
.\measurementA\cypher\run5\5_47.cypher;47;x;59;0;127
.\measurementA\cypher\run5\5_48.cypher;48;x;59;5;132
.\measurementA\cypher\run5\5_49.cypher;49;x;59;0;132
.\measurementA\cypher\run5\5_50.cypher;50;x;59;0;132
Model;Index;Size;InternalDiversity;NewShapes;AllCurrentShapes
.\measurementA\cypher\run6\6_1.cypher;1;x;59;59;59
.\measurementA\cypher\run6\6_2.cypher;2;x;58;6;65
.\measurementA\cypher\run6\6_3.cypher;3;x;59;8;73
.\measurementA\cypher\run6\6_4.cypher;4;x;62;20;93
.\measurementA\cypher\run6\6_5.cypher;5;x;62;10;103
.\measurementA\cypher\run6\6_6.cypher;6;x;62;10;113
.\measurementA\cypher\run6\6_7.cypher;7;x;59;7;120
.\measurementA\cypher\run6\6_8.cypher;8;x;60;0;120
.\measurementA\cypher\run6\6_9.cypher;9;x;60;0;120
.\measurementA\cypher\run6\6_10.cypher;10;x;60;1;121
.\measurementA\cypher\run6\6_11.cypher;11;x;59;4;125
.\measurementA\cypher\run6\6_12.cypher;12;x;60;1;126
.\measurementA\cypher\run6\6_13.cypher;13;x;60;0;126
.\measurementA\cypher\run6\6_14.cypher;14;x;60;2;128
.\measurementA\cypher\run6\6_15.cypher;15;x;58;4;132
.\measurementA\cypher\run6\6_16.cypher;16;x;59;0;132
.\measurementA\cypher\run6\6_17.cypher;17;x;59;0;132
.\measurementA\cypher\run6\6_18.cypher;18;x;59;0;132
.\measurementA\cypher\run6\6_19.cypher;19;x;60;4;136
.\measurementA\cypher\run6\6_20.cypher;20;x;60;2;138
.\measurementA\cypher\run6\6_21.cypher;21;x;60;4;142
.\measurementA\cypher\run6\6_22.cypher;22;x;60;0;142
.\measurementA\cypher\run6\6_23.cypher;23;x;59;2;144
.\measurementA\cypher\run6\6_24.cypher;24;x;60;0;144
.\measurementA\cypher\run6\6_25.cypher;25;x;59;0;144
.\measurementA\cypher\run6\6_26.cypher;26;x;60;0;144
.\measurementA\cypher\run6\6_27.cypher;27;x;64;6;150
.\measurementA\cypher\run6\6_28.cypher;28;x;64;6;156
.\measurementA\cypher\run6\6_29.cypher;29;x;64;6;162
.\measurementA\cypher\run6\6_30.cypher;30;x;68;10;172
.\measurementA\cypher\run6\6_31.cypher;31;x;68;0;172
.\measurementA\cypher\run6\6_32.cypher;32;x;68;9;181
.\measurementA\cypher\run6\6_33.cypher;33;x;68;9;190
.\measurementA\cypher\run6\6_34.cypher;34;x;63;4;194
.\measurementA\cypher\run6\6_35.cypher;35;x;63;2;196
.\measurementA\cypher\run6\6_36.cypher;36;x;63;3;199
.\measurementA\cypher\run6\6_37.cypher;37;x;63;0;199
.\measurementA\cypher\run6\6_38.cypher;38;x;63;2;201
.\measurementA\cypher\run6\6_39.cypher;39;x;63;0;201
.\measurementA\cypher\run6\6_40.cypher;40;x;63;5;206
.\measurementA\cypher\run6\6_41.cypher;41;x;63;5;211
.\measurementA\cypher\run6\6_42.cypher;42;x;63;1;212
.\measurementA\cypher\run6\6_43.cypher;43;x;61;3;215
.\measurementA\cypher\run6\6_44.cypher;44;x;61;0;215
.\measurementA\cypher\run6\6_45.cypher;45;x;61;0;215
.\measurementA\cypher\run6\6_46.cypher;46;x;61;0;215
.\measurementA\cypher\run6\6_47.cypher;47;x;60;4;219
.\measurementA\cypher\run6\6_48.cypher;48;x;60;0;219
.\measurementA\cypher\run6\6_49.cypher;49;x;60;0;219
.\measurementA\cypher\run6\6_50.cypher;50;x;60;0;219
Model;Index;Size;InternalDiversity;NewShapes;AllCurrentShapes
.\measurementA\cypher\run7\7_1.cypher;1;x;60;60;60
.\measurementA\cypher\run7\7_2.cypher;2;x;58;13;73
.\measurementA\cypher\run7\7_3.cypher;3;x;59;0;73
.\measurementA\cypher\run7\7_4.cypher;4;x;59;0;73
.\measurementA\cypher\run7\7_5.cypher;5;x;59;8;81
.\measurementA\cypher\run7\7_6.cypher;6;x;59;0;81
.\measurementA\cypher\run7\7_7.cypher;7;x;58;6;87
.\measurementA\cypher\run7\7_8.cypher;8;x;60;0;87
.\measurementA\cypher\run7\7_9.cypher;9;x;59;0;87
.\measurementA\cypher\run7\7_10.cypher;10;x;60;0;87
.\measurementA\cypher\run7\7_11.cypher;11;x;58;0;87
.\measurementA\cypher\run7\7_12.cypher;12;x;59;3;90
.\measurementA\cypher\run7\7_13.cypher;13;x;61;14;104
.\measurementA\cypher\run7\7_14.cypher;14;x;62;5;109
.\measurementA\cypher\run7\7_15.cypher;15;x;62;0;109
.\measurementA\cypher\run7\7_16.cypher;16;x;62;9;118
.\measurementA\cypher\run7\7_17.cypher;17;x;62;0;118
.\measurementA\cypher\run7\7_18.cypher;18;x;62;10;128
.\measurementA\cypher\run7\7_19.cypher;19;x;63;4;132
.\measurementA\cypher\run7\7_20.cypher;20;x;63;0;132
.\measurementA\cypher\run7\7_21.cypher;21;x;63;0;132
.\measurementA\cypher\run7\7_22.cypher;22;x;63;0;132
.\measurementA\cypher\run7\7_23.cypher;23;x;60;7;139
.\measurementA\cypher\run7\7_24.cypher;24;x;60;3;142
.\measurementA\cypher\run7\7_25.cypher;25;x;59;4;146
.\measurementA\cypher\run7\7_26.cypher;26;x;60;0;146
.\measurementA\cypher\run7\7_27.cypher;27;x;60;0;146
.\measurementA\cypher\run7\7_28.cypher;28;x;60;0;146
.\measurementA\cypher\run7\7_29.cypher;29;x;59;2;148
.\measurementA\cypher\run7\7_30.cypher;30;x;60;0;148
.\measurementA\cypher\run7\7_31.cypher;31;x;59;4;152
.\measurementA\cypher\run7\7_32.cypher;32;x;60;1;153
.\measurementA\cypher\run7\7_33.cypher;33;x;60;0;153
.\measurementA\cypher\run7\7_34.cypher;34;x;60;2;155
.\measurementA\cypher\run7\7_35.cypher;35;x;58;4;159
.\measurementA\cypher\run7\7_36.cypher;36;x;59;0;159
.\measurementA\cypher\run7\7_37.cypher;37;x;59;0;159
.\measurementA\cypher\run7\7_38.cypher;38;x;59;0;159
.\measurementA\cypher\run7\7_39.cypher;39;x;59;4;163
.\measurementA\cypher\run7\7_40.cypher;40;x;60;0;163
.\measurementA\cypher\run7\7_41.cypher;41;x;60;0;163
.\measurementA\cypher\run7\7_42.cypher;42;x;60;0;163
.\measurementA\cypher\run7\7_43.cypher;43;x;63;5;168
.\measurementA\cypher\run7\7_44.cypher;44;x;63;1;169
.\measurementA\cypher\run7\7_45.cypher;45;x;63;0;169
.\measurementA\cypher\run7\7_46.cypher;46;x;63;0;169
.\measurementA\cypher\run7\7_47.cypher;47;x;66;9;178
.\measurementA\cypher\run7\7_48.cypher;48;x;66;1;179
.\measurementA\cypher\run7\7_49.cypher;49;x;66;6;185
.\measurementA\cypher\run7\7_50.cypher;50;x;69;21;206
Model;Index;Size;InternalDiversity;NewShapes;AllCurrentShapes
.\measurementA\cypher\run8\8_1.cypher;1;x;53;53;53
.\measurementA\cypher\run8\8_2.cypher;2;x;55;9;62
.\measurementA\cypher\run8\8_3.cypher;3;x;52;5;67
.\measurementA\cypher\run8\8_4.cypher;4;x;53;0;67
.\measurementA\cypher\run8\8_5.cypher;5;x;52;0;67
.\measurementA\cypher\run8\8_6.cypher;6;x;53;0;67
.\measurementA\cypher\run8\8_7.cypher;7;x;53;3;70
.\measurementA\cypher\run8\8_8.cypher;8;x;55;0;70
.\measurementA\cypher\run8\8_9.cypher;9;x;55;0;70
.\measurementA\cypher\run8\8_10.cypher;10;x;52;0;70
.\measurementA\cypher\run8\8_11.cypher;11;x;53;8;78
.\measurementA\cypher\run8\8_12.cypher;12;x;53;0;78
.\measurementA\cypher\run8\8_13.cypher;13;x;53;0;78
.\measurementA\cypher\run8\8_14.cypher;14;x;53;0;78
.\measurementA\cypher\run8\8_15.cypher;15;x;55;6;84
.\measurementA\cypher\run8\8_16.cypher;16;x;53;0;84
.\measurementA\cypher\run8\8_17.cypher;17;x;55;0;84
.\measurementA\cypher\run8\8_18.cypher;18;x;55;0;84
.\measurementA\cypher\run8\8_19.cypher;19;x;55;19;103
.\measurementA\cypher\run8\8_20.cypher;20;x;56;2;105
.\measurementA\cypher\run8\8_21.cypher;21;x;58;1;106
.\measurementA\cypher\run8\8_22.cypher;22;x;55;0;106
.\measurementA\cypher\run8\8_23.cypher;23;x;56;3;109
.\measurementA\cypher\run8\8_24.cypher;24;x;55;0;109
.\measurementA\cypher\run8\8_25.cypher;25;x;56;0;109
.\measurementA\cypher\run8\8_26.cypher;26;x;56;0;109
.\measurementA\cypher\run8\8_27.cypher;27;x;58;0;109
.\measurementA\cypher\run8\8_28.cypher;28;x;58;0;109
.\measurementA\cypher\run8\8_29.cypher;29;x;56;0;109
.\measurementA\cypher\run8\8_30.cypher;30;x;56;0;109
.\measurementA\cypher\run8\8_31.cypher;31;x;62;21;130
.\measurementA\cypher\run8\8_32.cypher;32;x;62;9;139
.\measurementA\cypher\run8\8_33.cypher;33;x;62;10;149
.\measurementA\cypher\run8\8_34.cypher;34;x;55;5;154
.\measurementA\cypher\run8\8_35.cypher;35;x;56;1;155
.\measurementA\cypher\run8\8_36.cypher;36;x;58;0;155
.\measurementA\cypher\run8\8_37.cypher;37;x;56;0;155
.\measurementA\cypher\run8\8_38.cypher;38;x;60;2;157
.\measurementA\cypher\run8\8_39.cypher;39;x;62;0;157
.\measurementA\cypher\run8\8_40.cypher;40;x;62;0;157
.\measurementA\cypher\run8\8_41.cypher;41;x;60;0;157
.\measurementA\cypher\run8\8_42.cypher;42;x;62;0;157
.\measurementA\cypher\run8\8_43.cypher;43;x;62;0;157
.\measurementA\cypher\run8\8_44.cypher;44;x;62;7;164
.\measurementA\cypher\run8\8_45.cypher;45;x;61;3;167
.\measurementA\cypher\run8\8_46.cypher;46;x;56;7;174
.\measurementA\cypher\run8\8_47.cypher;47;x;56;0;174
.\measurementA\cypher\run8\8_48.cypher;48;x;54;1;175
.\measurementA\cypher\run8\8_49.cypher;49;x;54;0;175
.\measurementA\cypher\run8\8_50.cypher;50;x;56;0;175
Model;Index;Size;InternalDiversity;NewShapes;AllCurrentShapes
.\measurementA\cypher\run9\9_1.cypher;1;x;52;52;52
.\measurementA\cypher\run9\9_2.cypher;2;x;52;8;60
.\measurementA\cypher\run9\9_3.cypher;3;x;52;0;60
.\measurementA\cypher\run9\9_4.cypher;4;x;52;0;60
.\measurementA\cypher\run9\9_5.cypher;5;x;52;0;60
.\measurementA\cypher\run9\9_6.cypher;6;x;52;0;60
.\measurementA\cypher\run9\9_7.cypher;7;x;53;5;65
.\measurementA\cypher\run9\9_8.cypher;8;x;52;9;74
.\measurementA\cypher\run9\9_9.cypher;9;x;52;0;74
.\measurementA\cypher\run9\9_10.cypher;10;x;52;0;74
.\measurementA\cypher\run9\9_11.cypher;11;x;54;7;81
.\measurementA\cypher\run9\9_12.cypher;12;x;54;0;81
.\measurementA\cypher\run9\9_13.cypher;13;x;54;0;81
.\measurementA\cypher\run9\9_14.cypher;14;x;51;0;81
.\measurementA\cypher\run9\9_15.cypher;15;x;54;4;85
.\measurementA\cypher\run9\9_16.cypher;16;x;54;0;85
.\measurementA\cypher\run9\9_17.cypher;17;x;52;3;88
.\measurementA\cypher\run9\9_18.cypher;18;x;52;0;88
.\measurementA\cypher\run9\9_19.cypher;19;x;52;0;88
.\measurementA\cypher\run9\9_20.cypher;20;x;53;0;88
.\measurementA\cypher\run9\9_21.cypher;21;x;52;0;88
.\measurementA\cypher\run9\9_22.cypher;22;x;53;0;88
.\measurementA\cypher\run9\9_23.cypher;23;x;52;0;88
.\measurementA\cypher\run9\9_24.cypher;24;x;53;0;88
.\measurementA\cypher\run9\9_25.cypher;25;x;54;0;88
.\measurementA\cypher\run9\9_26.cypher;26;x;54;0;88
.\measurementA\cypher\run9\9_27.cypher;27;x;54;0;88
.\measurementA\cypher\run9\9_28.cypher;28;x;54;13;101
.\measurementA\cypher\run9\9_29.cypher;29;x;51;0;101
.\measurementA\cypher\run9\9_30.cypher;30;x;52;0;101
.\measurementA\cypher\run9\9_31.cypher;31;x;54;0;101
.\measurementA\cypher\run9\9_32.cypher;32;x;52;0;101
.\measurementA\cypher\run9\9_33.cypher;33;x;55;2;103
.\measurementA\cypher\run9\9_34.cypher;34;x;53;0;103
.\measurementA\cypher\run9\9_35.cypher;35;x;53;1;104
.\measurementA\cypher\run9\9_36.cypher;36;x;55;6;110
.\measurementA\cypher\run9\9_37.cypher;37;x;55;0;110
.\measurementA\cypher\run9\9_38.cypher;38;x;53;0;110
.\measurementA\cypher\run9\9_39.cypher;39;x;53;0;110
.\measurementA\cypher\run9\9_40.cypher;40;x;53;0;110
.\measurementA\cypher\run9\9_41.cypher;41;x;55;0;110
.\measurementA\cypher\run9\9_42.cypher;42;x;55;0;110
.\measurementA\cypher\run9\9_43.cypher;43;x;55;0;110
.\measurementA\cypher\run9\9_44.cypher;44;x;52;0;110
.\measurementA\cypher\run9\9_45.cypher;45;x;53;0;110
.\measurementA\cypher\run9\9_46.cypher;46;x;52;0;110
.\measurementA\cypher\run9\9_47.cypher;47;x;55;0;110
.\measurementA\cypher\run9\9_48.cypher;48;x;51;0;110
.\measurementA\cypher\run9\9_49.cypher;49;x;52;0;110
.\measurementA\cypher\run9\9_50.cypher;50;x;52;0;110
Model;Index;Size;InternalDiversity;NewShapes;AllCurrentShapes
.\measurementAp\cypher\run1\1_1.cypher;1;x;61;61;61
.\measurementAp\cypher\run1\1_2.cypher;2;x;63;8;69
.\measurementAp\cypher\run1\1_3.cypher;3;x;63;12;81
.\measurementAp\cypher\run1\1_4.cypher;4;x;63;13;94
.\measurementAp\cypher\run1\1_5.cypher;5;x;67;15;109
.\measurementAp\cypher\run1\1_6.cypher;6;x;71;16;125
.\measurementAp\cypher\run1\1_7.cypher;7;x;69;10;135
.\measurementAp\cypher\run1\1_8.cypher;8;x;71;9;144
.\measurementAp\cypher\run1\1_9.cypher;9;x;73;22;166
.\measurementAp\cypher\run1\1_10.cypher;10;x;74;3;169
.\measurementAp\cypher\run1\1_11.cypher;11;x;74;6;175
.\measurementAp\cypher\run1\1_12.cypher;12;x;74;8;183
.\measurementAp\cypher\run1\1_13.cypher;13;x;71;2;185
.\measurementAp\cypher\run1\1_14.cypher;14;x;75;7;192
.\measurementAp\cypher\run1\1_15.cypher;15;x;75;0;192
.\measurementAp\cypher\run1\1_16.cypher;16;x;75;1;193
.\measurementAp\cypher\run1\1_17.cypher;17;x;75;9;202
.\measurementAp\cypher\run1\1_18.cypher;18;x;74;4;206
.\measurementAp\cypher\run1\1_19.cypher;19;x;74;2;208
.\measurementAp\cypher\run1\1_20.cypher;20;x;74;0;208
.\measurementAp\cypher\run1\1_21.cypher;21;x;74;2;210
.\measurementAp\cypher\run1\1_22.cypher;22;x;75;4;214
.\measurementAp\cypher\run1\1_23.cypher;23;x;75;1;215
.\measurementAp\cypher\run1\1_24.cypher;24;x;75;0;215
.\measurementAp\cypher\run1\1_25.cypher;25;x;75;0;215
.\measurementAp\cypher\run1\1_26.cypher;26;x;75;4;219
.\measurementAp\cypher\run1\1_27.cypher;27;x;75;0;219
.\measurementAp\cypher\run1\1_28.cypher;28;x;75;0;219
.\measurementAp\cypher\run1\1_29.cypher;29;x;75;0;219
.\measurementAp\cypher\run1\1_30.cypher;30;x;75;4;223
.\measurementAp\cypher\run1\1_31.cypher;31;x;75;2;225
.\measurementAp\cypher\run1\1_32.cypher;32;x;75;0;225
.\measurementAp\cypher\run1\1_33.cypher;33;x;75;2;227
.\measurementAp\cypher\run1\1_34.cypher;34;x;78;19;246
.\measurementAp\cypher\run1\1_35.cypher;35;x;78;3;249
.\measurementAp\cypher\run1\1_36.cypher;36;x;69;6;255
.\measurementAp\cypher\run1\1_37.cypher;37;x;71;2;257
.\measurementAp\cypher\run1\1_38.cypher;38;x;71;1;258
.\measurementAp\cypher\run1\1_39.cypher;39;x;78;2;260
.\measurementAp\cypher\run1\1_40.cypher;40;x;77;1;261
.\measurementAp\cypher\run1\1_41.cypher;41;x;74;0;261
.\measurementAp\cypher\run1\1_42.cypher;42;x;74;0;261
.\measurementAp\cypher\run1\1_43.cypher;43;x;75;0;261
.\measurementAp\cypher\run1\1_44.cypher;44;x;75;0;261
.\measurementAp\cypher\run1\1_45.cypher;45;x;74;2;263
.\measurementAp\cypher\run1\1_46.cypher;46;x;75;0;263
.\measurementAp\cypher\run1\1_47.cypher;47;x;74;0;263
.\measurementAp\cypher\run1\1_48.cypher;48;x;75;0;263
.\measurementAp\cypher\run1\1_49.cypher;49;x;74;0;263
.\measurementAp\cypher\run1\1_50.cypher;50;x;75;0;263
Model;Index;Size;InternalDiversity;NewShapes;AllCurrentShapes
.\measurementAp\cypher\run10\10_1.cypher;1;x;75;75;75
.\measurementAp\cypher\run10\10_2.cypher;2;x;73;15;90
.\measurementAp\cypher\run10\10_3.cypher;3;x;77;9;99
.\measurementAp\cypher\run10\10_4.cypher;4;x;75;6;105
.\measurementAp\cypher\run10\10_5.cypher;5;x;81;17;122
.\measurementAp\cypher\run10\10_6.cypher;6;x;79;16;138
.\measurementAp\cypher\run10\10_7.cypher;7;x;83;0;138
.\measurementAp\cypher\run10\10_8.cypher;8;x;79;7;145
.\measurementAp\cypher\run10\10_9.cypher;9;x;81;16;161
.\measurementAp\cypher\run10\10_10.cypher;10;x;83;6;167
.\measurementAp\cypher\run10\10_11.cypher;11;x;86;15;182
.\measurementAp\cypher\run10\10_12.cypher;12;x;86;12;194
.\measurementAp\cypher\run10\10_13.cypher;13;x;87;12;206
.\measurementAp\cypher\run10\10_14.cypher;14;x;91;9;215
.\measurementAp\cypher\run10\10_15.cypher;15;x;91;2;217
.\measurementAp\cypher\run10\10_16.cypher;16;x;91;8;225
.\measurementAp\cypher\run10\10_17.cypher;17;x;89;10;235
.\measurementAp\cypher\run10\10_18.cypher;18;x;89;7;242
.\measurementAp\cypher\run10\10_19.cypher;19;x;91;6;248
.\measurementAp\cypher\run10\10_20.cypher;20;x;90;4;252
.\measurementAp\cypher\run10\10_21.cypher;21;x;92;0;252
.\measurementAp\cypher\run10\10_22.cypher;22;x;90;4;256
.\measurementAp\cypher\run10\10_23.cypher;23;x;92;2;258
.\measurementAp\cypher\run10\10_24.cypher;24;x;90;4;262
.\measurementAp\cypher\run10\10_25.cypher;25;x;92;0;262
.\measurementAp\cypher\run10\10_26.cypher;26;x;89;4;266
.\measurementAp\cypher\run10\10_27.cypher;27;x;91;0;266
.\measurementAp\cypher\run10\10_28.cypher;28;x;90;4;270
.\measurementAp\cypher\run10\10_29.cypher;29;x;92;2;272
.\measurementAp\cypher\run10\10_30.cypher;30;x;90;4;276
.\measurementAp\cypher\run10\10_31.cypher;31;x;92;0;276
.\measurementAp\cypher\run10\10_32.cypher;32;x;91;7;283
.\measurementAp\cypher\run10\10_33.cypher;33;x;91;3;286
.\measurementAp\cypher\run10\10_34.cypher;34;x;89;2;288
.\measurementAp\cypher\run10\10_35.cypher;35;x;94;13;301
.\measurementAp\cypher\run10\10_36.cypher;36;x;92;1;302
.\measurementAp\cypher\run10\10_37.cypher;37;x;94;2;304
.\measurementAp\cypher\run10\10_38.cypher;38;x;92;6;310
.\measurementAp\cypher\run10\10_39.cypher;39;x;89;2;312
.\measurementAp\cypher\run10\10_40.cypher;40;x;94;4;316
.\measurementAp\cypher\run10\10_41.cypher;41;x;91;0;316
.\measurementAp\cypher\run10\10_42.cypher;42;x;85;4;320
.\measurementAp\cypher\run10\10_43.cypher;43;x;93;1;321
.\measurementAp\cypher\run10\10_44.cypher;44;x;93;0;321
.\measurementAp\cypher\run10\10_45.cypher;45;x;91;0;321
.\measurementAp\cypher\run10\10_46.cypher;46;x;92;0;321
.\measurementAp\cypher\run10\10_47.cypher;47;x;92;0;321
.\measurementAp\cypher\run10\10_48.cypher;48;x;92;0;321
.\measurementAp\cypher\run10\10_49.cypher;49;x;92;0;321
.\measurementAp\cypher\run10\10_50.cypher;50;x;92;0;321
Model;Index;Size;InternalDiversity;NewShapes;AllCurrentShapes
.\measurementAp\cypher\run2\2_1.cypher;1;x;61;61;61
.\measurementAp\cypher\run2\2_2.cypher;2;x;63;8;69
.\measurementAp\cypher\run2\2_3.cypher;3;x;63;9;78
.\measurementAp\cypher\run2\2_4.cypher;4;x;63;12;90
.\measurementAp\cypher\run2\2_5.cypher;5;x;63;0;90
.\measurementAp\cypher\run2\2_6.cypher;6;x;63;0;90
.\measurementAp\cypher\run2\2_7.cypher;7;x;66;12;102
.\measurementAp\cypher\run2\2_8.cypher;8;x;66;2;104
.\measurementAp\cypher\run2\2_9.cypher;9;x;66;6;110
.\measurementAp\cypher\run2\2_10.cypher;10;x;66;0;110
.\measurementAp\cypher\run2\2_11.cypher;11;x;66;0;110
.\measurementAp\cypher\run2\2_12.cypher;12;x;66;6;116
.\measurementAp\cypher\run2\2_13.cypher;13;x;71;26;142
.\measurementAp\cypher\run2\2_14.cypher;14;x;71;6;148
.\measurementAp\cypher\run2\2_15.cypher;15;x;71;11;159
.\measurementAp\cypher\run2\2_16.cypher;16;x;70;12;171
.\measurementAp\cypher\run2\2_17.cypher;17;x;70;0;171
.\measurementAp\cypher\run2\2_18.cypher;18;x;72;1;172
.\measurementAp\cypher\run2\2_19.cypher;19;x;72;4;176
.\measurementAp\cypher\run2\2_20.cypher;20;x;70;5;181
.\measurementAp\cypher\run2\2_21.cypher;21;x;72;2;183
.\measurementAp\cypher\run2\2_22.cypher;22;x;69;4;187
.\measurementAp\cypher\run2\2_23.cypher;23;x;69;2;189
.\measurementAp\cypher\run2\2_24.cypher;24;x;71;0;189
.\measurementAp\cypher\run2\2_25.cypher;25;x;71;2;191
.\measurementAp\cypher\run2\2_26.cypher;26;x;70;2;193
.\measurementAp\cypher\run2\2_27.cypher;27;x;72;0;193
.\measurementAp\cypher\run2\2_28.cypher;28;x;70;4;197
.\measurementAp\cypher\run2\2_29.cypher;29;x;70;0;197
.\measurementAp\cypher\run2\2_30.cypher;30;x;72;0;197
.\measurementAp\cypher\run2\2_31.cypher;31;x;72;0;197
.\measurementAp\cypher\run2\2_32.cypher;32;x;70;4;201
.\measurementAp\cypher\run2\2_33.cypher;33;x;72;1;202
.\measurementAp\cypher\run2\2_34.cypher;34;x;70;0;202
.\measurementAp\cypher\run2\2_35.cypher;35;x;72;0;202
.\measurementAp\cypher\run2\2_36.cypher;36;x;67;1;203
.\measurementAp\cypher\run2\2_37.cypher;37;x;67;2;205
.\measurementAp\cypher\run2\2_38.cypher;38;x;67;2;207
.\measurementAp\cypher\run2\2_39.cypher;39;x;67;1;208
.\measurementAp\cypher\run2\2_40.cypher;40;x;67;1;209
.\measurementAp\cypher\run2\2_41.cypher;41;x;67;0;209
.\measurementAp\cypher\run2\2_42.cypher;42;x;67;1;210
.\measurementAp\cypher\run2\2_43.cypher;43;x;73;15;225
.\measurementAp\cypher\run2\2_44.cypher;44;x;67;0;225
.\measurementAp\cypher\run2\2_45.cypher;45;x;74;1;226
.\measurementAp\cypher\run2\2_46.cypher;46;x;73;0;226
.\measurementAp\cypher\run2\2_47.cypher;47;x;74;8;234
.\measurementAp\cypher\run2\2_48.cypher;48;x;74;11;245
.\measurementAp\cypher\run2\2_49.cypher;49;x;74;0;245
.\measurementAp\cypher\run2\2_50.cypher;50;x;66;2;247
Model;Index;Size;InternalDiversity;NewShapes;AllCurrentShapes
.\measurementAp\cypher\run3\3_1.cypher;1;x;58;58;58
.\measurementAp\cypher\run3\3_2.cypher;2;x;58;0;58
.\measurementAp\cypher\run3\3_3.cypher;3;x;59;8;66
.\measurementAp\cypher\run3\3_4.cypher;4;x;59;0;66
.\measurementAp\cypher\run3\3_5.cypher;5;x;58;0;66
.\measurementAp\cypher\run3\3_6.cypher;6;x;58;0;66
.\measurementAp\cypher\run3\3_7.cypher;7;x;58;0;66
.\measurementAp\cypher\run3\3_8.cypher;8;x;59;0;66
.\measurementAp\cypher\run3\3_9.cypher;9;x;59;0;66
.\measurementAp\cypher\run3\3_10.cypher;10;x;59;0;66
.\measurementAp\cypher\run3\3_11.cypher;11;x;59;0;66
.\measurementAp\cypher\run3\3_12.cypher;12;x;58;0;66
.\measurementAp\cypher\run3\3_13.cypher;13;x;59;7;73
.\measurementAp\cypher\run3\3_14.cypher;14;x;60;0;73
.\measurementAp\cypher\run3\3_15.cypher;15;x;59;0;73
.\measurementAp\cypher\run3\3_16.cypher;16;x;60;0;73
.\measurementAp\cypher\run3\3_17.cypher;17;x;60;0;73
.\measurementAp\cypher\run3\3_18.cypher;18;x;60;0;73
.\measurementAp\cypher\run3\3_19.cypher;19;x;60;10;83
.\measurementAp\cypher\run3\3_20.cypher;20;x;60;0;83
.\measurementAp\cypher\run3\3_21.cypher;21;x;60;4;87
.\measurementAp\cypher\run3\3_22.cypher;22;x;60;0;87
.\measurementAp\cypher\run3\3_23.cypher;23;x;60;2;89
.\measurementAp\cypher\run3\3_24.cypher;24;x;60;0;89
.\measurementAp\cypher\run3\3_25.cypher;25;x;60;0;89
.\measurementAp\cypher\run3\3_26.cypher;26;x;60;4;93
.\measurementAp\cypher\run3\3_27.cypher;27;x;60;0;93
.\measurementAp\cypher\run3\3_28.cypher;28;x;59;4;97
.\measurementAp\cypher\run3\3_29.cypher;29;x;59;0;97
.\measurementAp\cypher\run3\3_30.cypher;30;x;59;0;97
.\measurementAp\cypher\run3\3_31.cypher;31;x;59;0;97
.\measurementAp\cypher\run3\3_32.cypher;32;x;59;0;97
.\measurementAp\cypher\run3\3_33.cypher;33;x;60;0;97
.\measurementAp\cypher\run3\3_34.cypher;34;x;60;0;97
.\measurementAp\cypher\run3\3_35.cypher;35;x;64;18;115
.\measurementAp\cypher\run3\3_36.cypher;36;x;64;13;128
.\measurementAp\cypher\run3\3_37.cypher;37;x;64;0;128
.\measurementAp\cypher\run3\3_38.cypher;38;x;64;0;128
.\measurementAp\cypher\run3\3_39.cypher;39;x;64;8;136
.\measurementAp\cypher\run3\3_40.cypher;40;x;64;0;136
.\measurementAp\cypher\run3\3_41.cypher;41;x;59;4;140
.\measurementAp\cypher\run3\3_42.cypher;42;x;60;2;142
.\measurementAp\cypher\run3\3_43.cypher;43;x;60;0;142
.\measurementAp\cypher\run3\3_44.cypher;44;x;60;0;142
.\measurementAp\cypher\run3\3_45.cypher;45;x;59;0;142
.\measurementAp\cypher\run3\3_46.cypher;46;x;60;2;144
.\measurementAp\cypher\run3\3_47.cypher;47;x;60;0;144
.\measurementAp\cypher\run3\3_48.cypher;48;x;64;2;146
.\measurementAp\cypher\run3\3_49.cypher;49;x;60;0;146
.\measurementAp\cypher\run3\3_50.cypher;50;x;64;0;146
Model;Index;Size;InternalDiversity;NewShapes;AllCurrentShapes
.\measurementAp\cypher\run4\4_1.cypher;1;x;59;59;59
.\measurementAp\cypher\run4\4_2.cypher;2;x;59;0;59
.\measurementAp\cypher\run4\4_3.cypher;3;x;60;7;66
.\measurementAp\cypher\run4\4_4.cypher;4;x;60;0;66
.\measurementAp\cypher\run4\4_5.cypher;5;x;59;10;76
.\measurementAp\cypher\run4\4_6.cypher;6;x;61;1;77
.\measurementAp\cypher\run4\4_7.cypher;7;x;60;0;77
.\measurementAp\cypher\run4\4_8.cypher;8;x;61;10;87
.\measurementAp\cypher\run4\4_9.cypher;9;x;59;5;92
.\measurementAp\cypher\run4\4_10.cypher;10;x;60;1;93
.\measurementAp\cypher\run4\4_11.cypher;11;x;61;0;93
.\measurementAp\cypher\run4\4_12.cypher;12;x;61;2;95
.\measurementAp\cypher\run4\4_13.cypher;13;x;59;4;99
.\measurementAp\cypher\run4\4_14.cypher;14;x;61;0;99
.\measurementAp\cypher\run4\4_15.cypher;15;x;60;0;99
.\measurementAp\cypher\run4\4_16.cypher;16;x;61;0;99
.\measurementAp\cypher\run4\4_17.cypher;17;x;58;4;103
.\measurementAp\cypher\run4\4_18.cypher;18;x;59;0;103
.\measurementAp\cypher\run4\4_19.cypher;19;x;60;0;103
.\measurementAp\cypher\run4\4_20.cypher;20;x;60;0;103
.\measurementAp\cypher\run4\4_21.cypher;21;x;61;4;107
.\measurementAp\cypher\run4\4_22.cypher;22;x;61;2;109
.\measurementAp\cypher\run4\4_23.cypher;23;x;59;2;111
.\measurementAp\cypher\run4\4_24.cypher;24;x;60;0;111
.\measurementAp\cypher\run4\4_25.cypher;25;x;62;12;123
.\measurementAp\cypher\run4\4_26.cypher;26;x;63;0;123
.\measurementAp\cypher\run4\4_27.cypher;27;x;63;5;128
.\measurementAp\cypher\run4\4_28.cypher;28;x;63;13;141
.\measurementAp\cypher\run4\4_29.cypher;29;x;63;1;142
.\measurementAp\cypher\run4\4_30.cypher;30;x;63;0;142
.\measurementAp\cypher\run4\4_31.cypher;31;x;63;0;142
.\measurementAp\cypher\run4\4_32.cypher;32;x;63;5;147
.\measurementAp\cypher\run4\4_33.cypher;33;x;63;0;147
.\measurementAp\cypher\run4\4_34.cypher;34;x;63;0;147
.\measurementAp\cypher\run4\4_35.cypher;35;x;63;8;155
.\measurementAp\cypher\run4\4_36.cypher;36;x;63;2;157
.\measurementAp\cypher\run4\4_37.cypher;37;x;63;2;159
.\measurementAp\cypher\run4\4_38.cypher;38;x;64;0;159
.\measurementAp\cypher\run4\4_39.cypher;39;x;64;1;160
.\measurementAp\cypher\run4\4_40.cypher;40;x;64;0;160
.\measurementAp\cypher\run4\4_41.cypher;41;x;64;0;160
.\measurementAp\cypher\run4\4_42.cypher;42;x;64;0;160
.\measurementAp\cypher\run4\4_43.cypher;43;x;64;0;160
.\measurementAp\cypher\run4\4_44.cypher;44;x;64;1;161
.\measurementAp\cypher\run4\4_45.cypher;45;x;64;0;161
.\measurementAp\cypher\run4\4_46.cypher;46;x;64;1;162
.\measurementAp\cypher\run4\4_47.cypher;47;x;64;0;162
.\measurementAp\cypher\run4\4_48.cypher;48;x;64;0;162
.\measurementAp\cypher\run4\4_49.cypher;49;x;64;0;162
.\measurementAp\cypher\run4\4_50.cypher;50;x;64;0;162
Model;Index;Size;InternalDiversity;NewShapes;AllCurrentShapes
.\measurementAp\cypher\run5\5_1.cypher;1;x;59;59;59
.\measurementAp\cypher\run5\5_2.cypher;2;x;63;13;72
.\measurementAp\cypher\run5\5_3.cypher;3;x;63;9;81
.\measurementAp\cypher\run5\5_4.cypher;4;x;63;12;93
.\measurementAp\cypher\run5\5_5.cypher;5;x;67;16;109
.\measurementAp\cypher\run5\5_6.cypher;6;x;67;1;110
.\measurementAp\cypher\run5\5_7.cypher;7;x;67;1;111
.\measurementAp\cypher\run5\5_8.cypher;8;x;67;5;116
.\measurementAp\cypher\run5\5_9.cypher;9;x;65;8;124
.\measurementAp\cypher\run5\5_10.cypher;10;x;66;7;131
.\measurementAp\cypher\run5\5_11.cypher;11;x;66;0;131
.\measurementAp\cypher\run5\5_12.cypher;12;x;66;0;131
.\measurementAp\cypher\run5\5_13.cypher;13;x;66;8;139
.\measurementAp\cypher\run5\5_14.cypher;14;x;66;4;143
.\measurementAp\cypher\run5\5_15.cypher;15;x;66;0;143
.\measurementAp\cypher\run5\5_16.cypher;16;x;66;0;143
.\measurementAp\cypher\run5\5_17.cypher;17;x;66;0;143
.\measurementAp\cypher\run5\5_18.cypher;18;x;66;4;147
.\measurementAp\cypher\run5\5_19.cypher;19;x;66;2;149
.\measurementAp\cypher\run5\5_20.cypher;20;x;66;0;149
.\measurementAp\cypher\run5\5_21.cypher;21;x;66;2;151
.\measurementAp\cypher\run5\5_22.cypher;22;x;66;4;155
.\measurementAp\cypher\run5\5_23.cypher;23;x;66;0;155
.\measurementAp\cypher\run5\5_24.cypher;24;x;65;4;159
.\measurementAp\cypher\run5\5_25.cypher;25;x;65;2;161
.\measurementAp\cypher\run5\5_26.cypher;26;x;66;0;161
.\measurementAp\cypher\run5\5_27.cypher;27;x;66;0;161
.\measurementAp\cypher\run5\5_28.cypher;28;x;65;2;163
.\measurementAp\cypher\run5\5_29.cypher;29;x;65;0;163
.\measurementAp\cypher\run5\5_30.cypher;30;x;71;14;177
.\measurementAp\cypher\run5\5_31.cypher;31;x;71;1;178
.\measurementAp\cypher\run5\5_32.cypher;32;x;71;7;185
.\measurementAp\cypher\run5\5_33.cypher;33;x;71;0;185
.\measurementAp\cypher\run5\5_34.cypher;34;x;71;2;187
.\measurementAp\cypher\run5\5_35.cypher;35;x;74;17;204
.\measurementAp\cypher\run5\5_36.cypher;36;x;74;11;215
.\measurementAp\cypher\run5\5_37.cypher;37;x;69;3;218
.\measurementAp\cypher\run5\5_38.cypher;38;x;71;1;219
.\measurementAp\cypher\run5\5_39.cypher;39;x;71;0;219
.\measurementAp\cypher\run5\5_40.cypher;40;x;71;0;219
.\measurementAp\cypher\run5\5_41.cypher;41;x;73;7;226
.\measurementAp\cypher\run5\5_42.cypher;42;x;74;2;228
.\measurementAp\cypher\run5\5_43.cypher;43;x;74;3;231
.\measurementAp\cypher\run5\5_44.cypher;44;x;77;7;238
.\measurementAp\cypher\run5\5_45.cypher;45;x;77;9;247
.\measurementAp\cypher\run5\5_46.cypher;46;x;77;2;249
.\measurementAp\cypher\run5\5_47.cypher;47;x;78;4;253
.\measurementAp\cypher\run5\5_48.cypher;48;x;78;2;255
.\measurementAp\cypher\run5\5_49.cypher;49;x;78;1;256
.\measurementAp\cypher\run5\5_50.cypher;50;x;78;0;256
Model;Index;Size;InternalDiversity;NewShapes;AllCurrentShapes
.\measurementAp\cypher\run6\6_1.cypher;1;x;63;63;63
.\measurementAp\cypher\run6\6_2.cypher;2;x;63;12;75
.\measurementAp\cypher\run6\6_3.cypher;3;x;63;13;88
.\measurementAp\cypher\run6\6_4.cypher;4;x;66;12;100
.\measurementAp\cypher\run6\6_5.cypher;5;x;66;7;107
.\measurementAp\cypher\run6\6_6.cypher;6;x;66;6;113
.\measurementAp\cypher\run6\6_7.cypher;7;x;69;21;134
.\measurementAp\cypher\run6\6_8.cypher;8;x;71;11;145
.\measurementAp\cypher\run6\6_9.cypher;9;x;71;4;149
.\measurementAp\cypher\run6\6_10.cypher;10;x;71;6;155
.\measurementAp\cypher\run6\6_11.cypher;11;x;71;3;158
.\measurementAp\cypher\run6\6_12.cypher;12;x;69;3;161
.\measurementAp\cypher\run6\6_13.cypher;13;x;71;2;163
.\measurementAp\cypher\run6\6_14.cypher;14;x;71;1;164
.\measurementAp\cypher\run6\6_15.cypher;15;x;74;10;174
.\measurementAp\cypher\run6\6_16.cypher;16;x;74;5;179
.\measurementAp\cypher\run6\6_17.cypher;17;x;74;8;187
.\measurementAp\cypher\run6\6_18.cypher;18;x;67;12;199
.\measurementAp\cypher\run6\6_19.cypher;19;x;67;0;199
.\measurementAp\cypher\run6\6_20.cypher;20;x;67;0;199
.\measurementAp\cypher\run6\6_21.cypher;21;x;67;0;199
.\measurementAp\cypher\run6\6_22.cypher;22;x;65;0;199
.\measurementAp\cypher\run6\6_23.cypher;23;x;65;0;199
.\measurementAp\cypher\run6\6_24.cypher;24;x;68;4;203
.\measurementAp\cypher\run6\6_25.cypher;25;x;68;0;203
.\measurementAp\cypher\run6\6_26.cypher;26;x;68;0;203
.\measurementAp\cypher\run6\6_27.cypher;27;x;68;0;203
.\measurementAp\cypher\run6\6_28.cypher;28;x;66;1;204
.\measurementAp\cypher\run6\6_29.cypher;29;x;66;0;204
.\measurementAp\cypher\run6\6_30.cypher;30;x;68;4;208
.\measurementAp\cypher\run6\6_31.cypher;31;x;68;2;210
.\measurementAp\cypher\run6\6_32.cypher;32;x;68;0;210
.\measurementAp\cypher\run6\6_33.cypher;33;x;66;2;212
.\measurementAp\cypher\run6\6_34.cypher;34;x;68;0;212
.\measurementAp\cypher\run6\6_35.cypher;35;x;66;2;214
.\measurementAp\cypher\run6\6_36.cypher;36;x;78;12;226
.\measurementAp\cypher\run6\6_37.cypher;37;x;78;10;236
.\measurementAp\cypher\run6\6_38.cypher;38;x;77;11;247
.\measurementAp\cypher\run6\6_39.cypher;39;x;68;4;251
.\measurementAp\cypher\run6\6_40.cypher;40;x;68;2;253
.\measurementAp\cypher\run6\6_41.cypher;41;x;68;0;253
.\measurementAp\cypher\run6\6_42.cypher;42;x;66;2;255
.\measurementAp\cypher\run6\6_43.cypher;43;x;68;0;255
.\measurementAp\cypher\run6\6_44.cypher;44;x;66;2;257
.\measurementAp\cypher\run6\6_45.cypher;45;x;68;4;261
.\measurementAp\cypher\run6\6_46.cypher;46;x;68;1;262
.\measurementAp\cypher\run6\6_47.cypher;47;x;68;0;262
.\measurementAp\cypher\run6\6_48.cypher;48;x;68;0;262
.\measurementAp\cypher\run6\6_49.cypher;49;x;66;0;262
.\measurementAp\cypher\run6\6_50.cypher;50;x;66;0;262
Model;Index;Size;InternalDiversity;NewShapes;AllCurrentShapes
.\measurementAp\cypher\run7\7_1.cypher;1;x;58;58;58
.\measurementAp\cypher\run7\7_2.cypher;2;x;58;0;58
.\measurementAp\cypher\run7\7_3.cypher;3;x;59;8;66
.\measurementAp\cypher\run7\7_4.cypher;4;x;58;0;66
.\measurementAp\cypher\run7\7_5.cypher;5;x;59;0;66
.\measurementAp\cypher\run7\7_6.cypher;6;x;59;0;66
.\measurementAp\cypher\run7\7_7.cypher;7;x;63;19;85
.\measurementAp\cypher\run7\7_8.cypher;8;x;63;13;98
.\measurementAp\cypher\run7\7_9.cypher;9;x;63;0;98
.\measurementAp\cypher\run7\7_10.cypher;10;x;63;0;98
.\measurementAp\cypher\run7\7_11.cypher;11;x;63;0;98
.\measurementAp\cypher\run7\7_12.cypher;12;x;63;0;98
.\measurementAp\cypher\run7\7_13.cypher;13;x;63;10;108
.\measurementAp\cypher\run7\7_14.cypher;14;x;63;0;108
.\measurementAp\cypher\run7\7_15.cypher;15;x;63;0;108
.\measurementAp\cypher\run7\7_16.cypher;16;x;66;15;123
.\measurementAp\cypher\run7\7_17.cypher;17;x;66;7;130
.\measurementAp\cypher\run7\7_18.cypher;18;x;66;6;136
.\measurementAp\cypher\run7\7_19.cypher;19;x;70;11;147
.\measurementAp\cypher\run7\7_20.cypher;20;x;68;12;159
.\measurementAp\cypher\run7\7_21.cypher;21;x;68;10;169
.\measurementAp\cypher\run7\7_22.cypher;22;x;66;4;173
.\measurementAp\cypher\run7\7_23.cypher;23;x;66;0;173
.\measurementAp\cypher\run7\7_24.cypher;24;x;66;1;174
.\measurementAp\cypher\run7\7_25.cypher;25;x;66;1;175
.\measurementAp\cypher\run7\7_26.cypher;26;x;64;7;182
.\measurementAp\cypher\run7\7_27.cypher;27;x;64;2;184
.\measurementAp\cypher\run7\7_28.cypher;28;x;64;2;186
.\measurementAp\cypher\run7\7_29.cypher;29;x;64;0;186
.\measurementAp\cypher\run7\7_30.cypher;30;x;64;2;188
.\measurementAp\cypher\run7\7_31.cypher;31;x;64;0;188
.\measurementAp\cypher\run7\7_32.cypher;32;x;69;6;194
.\measurementAp\cypher\run7\7_33.cypher;33;x;69;4;198
.\measurementAp\cypher\run7\7_34.cypher;34;x;64;4;202
.\measurementAp\cypher\run7\7_35.cypher;35;x;64;0;202
.\measurementAp\cypher\run7\7_36.cypher;36;x;64;0;202
.\measurementAp\cypher\run7\7_37.cypher;37;x;64;0;202
.\measurementAp\cypher\run7\7_38.cypher;38;x;64;4;206
.\measurementAp\cypher\run7\7_39.cypher;39;x;64;2;208
.\measurementAp\cypher\run7\7_40.cypher;40;x;64;0;208
.\measurementAp\cypher\run7\7_41.cypher;41;x;64;2;210
.\measurementAp\cypher\run7\7_42.cypher;42;x;64;0;210
.\measurementAp\cypher\run7\7_43.cypher;43;x;64;2;212
.\measurementAp\cypher\run7\7_44.cypher;44;x;64;4;216
.\measurementAp\cypher\run7\7_45.cypher;45;x;64;0;216
.\measurementAp\cypher\run7\7_46.cypher;46;x;63;4;220
.\measurementAp\cypher\run7\7_47.cypher;47;x;63;0;220
.\measurementAp\cypher\run7\7_48.cypher;48;x;63;0;220
.\measurementAp\cypher\run7\7_49.cypher;49;x;63;1;221
.\measurementAp\cypher\run7\7_50.cypher;50;x;63;0;221
Model;Index;Size;InternalDiversity;NewShapes;AllCurrentShapes
.\measurementAp\cypher\run8\8_1.cypher;1;x;63;63;63
.\measurementAp\cypher\run8\8_2.cypher;2;x;63;15;78
.\measurementAp\cypher\run8\8_3.cypher;3;x;63;9;87
.\measurementAp\cypher\run8\8_4.cypher;4;x;63;7;94
.\measurementAp\cypher\run8\8_5.cypher;5;x;63;0;94
.\measurementAp\cypher\run8\8_6.cypher;6;x;63;1;95
.\measurementAp\cypher\run8\8_7.cypher;7;x;63;0;95
.\measurementAp\cypher\run8\8_8.cypher;8;x;63;7;102
.\measurementAp\cypher\run8\8_9.cypher;9;x;63;0;102
.\measurementAp\cypher\run8\8_10.cypher;10;x;64;4;106
.\measurementAp\cypher\run8\8_11.cypher;11;x;64;0;106
.\measurementAp\cypher\run8\8_12.cypher;12;x;64;0;106
.\measurementAp\cypher\run8\8_13.cypher;13;x;64;0;106
.\measurementAp\cypher\run8\8_14.cypher;14;x;64;0;106
.\measurementAp\cypher\run8\8_15.cypher;15;x;64;0;106
.\measurementAp\cypher\run8\8_16.cypher;16;x;64;4;110
.\measurementAp\cypher\run8\8_17.cypher;17;x;64;0;110
.\measurementAp\cypher\run8\8_18.cypher;18;x;64;1;111
.\measurementAp\cypher\run8\8_19.cypher;19;x;64;0;111
.\measurementAp\cypher\run8\8_20.cypher;20;x;64;0;111
.\measurementAp\cypher\run8\8_21.cypher;21;x;64;0;111
.\measurementAp\cypher\run8\8_22.cypher;22;x;64;4;115
.\measurementAp\cypher\run8\8_23.cypher;23;x;64;2;117
.\measurementAp\cypher\run8\8_24.cypher;24;x;64;0;117
.\measurementAp\cypher\run8\8_25.cypher;25;x;64;2;119
.\measurementAp\cypher\run8\8_26.cypher;26;x;64;0;119
.\measurementAp\cypher\run8\8_27.cypher;27;x;64;2;121
.\measurementAp\cypher\run8\8_28.cypher;28;x;64;4;125
.\measurementAp\cypher\run8\8_29.cypher;29;x;64;2;127
.\measurementAp\cypher\run8\8_30.cypher;30;x;64;2;129
.\measurementAp\cypher\run8\8_31.cypher;31;x;64;0;129
.\measurementAp\cypher\run8\8_32.cypher;32;x;64;0;129
.\measurementAp\cypher\run8\8_33.cypher;33;x;64;2;131
.\measurementAp\cypher\run8\8_34.cypher;34;x;67;15;146
.\measurementAp\cypher\run8\8_35.cypher;35;x;71;15;161
.\measurementAp\cypher\run8\8_36.cypher;36;x;68;5;166
.\measurementAp\cypher\run8\8_37.cypher;37;x;68;0;166
.\measurementAp\cypher\run8\8_38.cypher;38;x;68;0;166
.\measurementAp\cypher\run8\8_39.cypher;39;x;68;0;166
.\measurementAp\cypher\run8\8_40.cypher;40;x;68;0;166
.\measurementAp\cypher\run8\8_41.cypher;41;x;68;6;172
.\measurementAp\cypher\run8\8_42.cypher;42;x;68;9;181
.\measurementAp\cypher\run8\8_43.cypher;43;x;68;0;181
.\measurementAp\cypher\run8\8_44.cypher;44;x;68;4;185
.\measurementAp\cypher\run8\8_45.cypher;45;x;68;4;189
.\measurementAp\cypher\run8\8_46.cypher;46;x;69;2;191
.\measurementAp\cypher\run8\8_47.cypher;47;x;69;0;191
.\measurementAp\cypher\run8\8_48.cypher;48;x;68;4;195
.\measurementAp\cypher\run8\8_49.cypher;49;x;68;0;195
.\measurementAp\cypher\run8\8_50.cypher;50;x;69;2;197
Model;Index;Size;InternalDiversity;NewShapes;AllCurrentShapes
.\measurementAp\cypher\run9\9_1.cypher;1;x;59;59;59
.\measurementAp\cypher\run9\9_2.cypher;2;x;63;13;72
.\measurementAp\cypher\run9\9_3.cypher;3;x;63;0;72
.\measurementAp\cypher\run9\9_4.cypher;4;x;63;12;84
.\measurementAp\cypher\run9\9_5.cypher;5;x;63;0;84
.\measurementAp\cypher\run9\9_6.cypher;6;x;59;0;84
.\measurementAp\cypher\run9\9_7.cypher;7;x;63;9;93
.\measurementAp\cypher\run9\9_8.cypher;8;x;63;0;93
.\measurementAp\cypher\run9\9_9.cypher;9;x;67;16;109
.\measurementAp\cypher\run9\9_10.cypher;10;x;67;5;114
.\measurementAp\cypher\run9\9_11.cypher;11;x;67;0;114
.\measurementAp\cypher\run9\9_12.cypher;12;x;67;0;114
.\measurementAp\cypher\run9\9_13.cypher;13;x;65;9;123
.\measurementAp\cypher\run9\9_14.cypher;14;x;65;0;123
.\measurementAp\cypher\run9\9_15.cypher;15;x;66;6;129
.\measurementAp\cypher\run9\9_16.cypher;16;x;66;3;132
.\measurementAp\cypher\run9\9_17.cypher;17;x;66;0;132
.\measurementAp\cypher\run9\9_18.cypher;18;x;66;2;134
.\measurementAp\cypher\run9\9_19.cypher;19;x;66;0;134
.\measurementAp\cypher\run9\9_20.cypher;20;x;66;0;134
.\measurementAp\cypher\run9\9_21.cypher;21;x;63;0;134
.\measurementAp\cypher\run9\9_22.cypher;22;x;63;0;134
.\measurementAp\cypher\run9\9_23.cypher;23;x;63;0;134
.\measurementAp\cypher\run9\9_24.cypher;24;x;63;0;134
.\measurementAp\cypher\run9\9_25.cypher;25;x;63;0;134
.\measurementAp\cypher\run9\9_26.cypher;26;x;63;0;134
.\measurementAp\cypher\run9\9_27.cypher;27;x;71;17;151
.\measurementAp\cypher\run9\9_28.cypher;28;x;71;9;160
.\measurementAp\cypher\run9\9_29.cypher;29;x;71;4;164
.\measurementAp\cypher\run9\9_30.cypher;30;x;69;3;167
.\measurementAp\cypher\run9\9_31.cypher;31;x;71;3;170
.\measurementAp\cypher\run9\9_32.cypher;32;x;67;2;172
.\measurementAp\cypher\run9\9_33.cypher;33;x;67;0;172
.\measurementAp\cypher\run9\9_34.cypher;34;x;71;3;175
.\measurementAp\cypher\run9\9_35.cypher;35;x;71;0;175
.\measurementAp\cypher\run9\9_36.cypher;36;x;67;0;175
.\measurementAp\cypher\run9\9_37.cypher;37;x;67;0;175
.\measurementAp\cypher\run9\9_38.cypher;38;x;67;0;175
.\measurementAp\cypher\run9\9_39.cypher;39;x;71;2;177
.\measurementAp\cypher\run9\9_40.cypher;40;x;67;0;177
.\measurementAp\cypher\run9\9_41.cypher;41;x;71;1;178
.\measurementAp\cypher\run9\9_42.cypher;42;x;71;0;178
.\measurementAp\cypher\run9\9_43.cypher;43;x;69;1;179
.\measurementAp\cypher\run9\9_44.cypher;44;x;69;0;179
.\measurementAp\cypher\run9\9_45.cypher;45;x;74;16;195
.\measurementAp\cypher\run9\9_46.cypher;46;x;71;5;200
.\measurementAp\cypher\run9\9_47.cypher;47;x;71;0;200
.\measurementAp\cypher\run9\9_48.cypher;48;x;72;7;207
.\measurementAp\cypher\run9\9_49.cypher;49;x;72;1;208
.\measurementAp\cypher\run9\9_50.cypher;50;x;71;4;212
Model;Index;Size;InternalDiversity;NewShapes;AllCurrentShapes
.\measurementApp\cypher\run1\1_1.cypher;1;x;72;72;72
.\measurementApp\cypher\run1\1_2.cypher;2;x;72;33;105
.\measurementApp\cypher\run1\1_3.cypher;3;x;75;16;121
.\measurementApp\cypher\run1\1_4.cypher;4;x;78;15;136
.\measurementApp\cypher\run1\1_5.cypher;5;x;78;8;144
.\measurementApp\cypher\run1\1_6.cypher;6;x;75;5;149
.\measurementApp\cypher\run1\1_7.cypher;7;x;75;2;151
.\measurementApp\cypher\run1\1_8.cypher;8;x;78;2;153
.\measurementApp\cypher\run1\1_9.cypher;9;x;74;4;157
.\measurementApp\cypher\run1\1_10.cypher;10;x;74;2;159
.\measurementApp\cypher\run1\1_11.cypher;11;x;74;2;161
.\measurementApp\cypher\run1\1_12.cypher;12;x;79;17;178
.\measurementApp\cypher\run1\1_13.cypher;13;x;80;9;187
.\measurementApp\cypher\run1\1_14.cypher;14;x;85;22;209
.\measurementApp\cypher\run1\1_15.cypher;15;x;85;6;215
.\measurementApp\cypher\run1\1_16.cypher;16;x;85;6;221
.\measurementApp\cypher\run1\1_17.cypher;17;x;80;15;236
.\measurementApp\cypher\run1\1_18.cypher;18;x;80;5;241
.\measurementApp\cypher\run1\1_19.cypher;19;x;80;4;245
.\measurementApp\cypher\run1\1_20.cypher;20;x;78;4;249
.\measurementApp\cypher\run1\1_21.cypher;21;x;79;6;255
.\measurementApp\cypher\run1\1_22.cypher;22;x;80;3;258
.\measurementApp\cypher\run1\1_23.cypher;23;x;80;1;259
.\measurementApp\cypher\run1\1_24.cypher;24;x;80;0;259
.\measurementApp\cypher\run1\1_25.cypher;25;x;79;3;262
.\measurementApp\cypher\run1\1_26.cypher;26;x;79;0;262
.\measurementApp\cypher\run1\1_27.cypher;27;x;80;2;264
.\measurementApp\cypher\run1\1_28.cypher;28;x;80;0;264
.\measurementApp\cypher\run1\1_29.cypher;29;x;78;8;272
.\measurementApp\cypher\run1\1_30.cypher;30;x;78;0;272
.\measurementApp\cypher\run1\1_31.cypher;31;x;78;0;272
.\measurementApp\cypher\run1\1_32.cypher;32;x;85;12;284
.\measurementApp\cypher\run1\1_33.cypher;33;x;78;1;285
.\measurementApp\cypher\run1\1_34.cypher;34;x;79;4;289
.\measurementApp\cypher\run1\1_35.cypher;35;x;79;2;291
.\measurementApp\cypher\run1\1_36.cypher;36;x;79;0;291
.\measurementApp\cypher\run1\1_37.cypher;37;x;79;2;293
.\measurementApp\cypher\run1\1_38.cypher;38;x;79;4;297
.\measurementApp\cypher\run1\1_39.cypher;39;x;79;0;297
.\measurementApp\cypher\run1\1_40.cypher;40;x;79;0;297
.\measurementApp\cypher\run1\1_41.cypher;41;x;79;0;297
.\measurementApp\cypher\run1\1_42.cypher;42;x;79;4;301
.\measurementApp\cypher\run1\1_43.cypher;43;x;79;2;303
.\measurementApp\cypher\run1\1_44.cypher;44;x;79;0;303
.\measurementApp\cypher\run1\1_45.cypher;45;x;79;2;305
.\measurementApp\cypher\run1\1_46.cypher;46;x;79;1;306
.\measurementApp\cypher\run1\1_47.cypher;47;x;79;0;306
.\measurementApp\cypher\run1\1_48.cypher;48;x;79;0;306
.\measurementApp\cypher\run1\1_49.cypher;49;x;79;0;306
.\measurementApp\cypher\run1\1_50.cypher;50;x;79;4;310
Model;Index;Size;InternalDiversity;NewShapes;AllCurrentShapes
.\measurementApp\cypher\run10\10_1.cypher;1;x;71;71;71
.\measurementApp\cypher\run10\10_2.cypher;2;x;72;16;87
.\measurementApp\cypher\run10\10_3.cypher;3;x;71;0;87
.\measurementApp\cypher\run10\10_4.cypher;4;x;72;9;96
.\measurementApp\cypher\run10\10_5.cypher;5;x;77;32;128
.\measurementApp\cypher\run10\10_6.cypher;6;x;78;10;138
.\measurementApp\cypher\run10\10_7.cypher;7;x;78;8;146
.\measurementApp\cypher\run10\10_8.cypher;8;x;73;7;153
.\measurementApp\cypher\run10\10_9.cypher;9;x;73;6;159
.\measurementApp\cypher\run10\10_10.cypher;10;x;75;11;170
.\measurementApp\cypher\run10\10_11.cypher;11;x;76;10;180
.\measurementApp\cypher\run10\10_12.cypher;12;x;76;0;180
.\measurementApp\cypher\run10\10_13.cypher;13;x;76;6;186
.\measurementApp\cypher\run10\10_14.cypher;14;x;75;5;191
.\measurementApp\cypher\run10\10_15.cypher;15;x;74;4;195
.\measurementApp\cypher\run10\10_16.cypher;16;x;75;6;201
.\measurementApp\cypher\run10\10_17.cypher;17;x;75;9;210
.\measurementApp\cypher\run10\10_18.cypher;18;x;75;0;210
.\measurementApp\cypher\run10\10_19.cypher;19;x;75;0;210
.\measurementApp\cypher\run10\10_20.cypher;20;x;74;0;210
.\measurementApp\cypher\run10\10_21.cypher;21;x;78;5;215
.\measurementApp\cypher\run10\10_22.cypher;22;x;74;4;219
.\measurementApp\cypher\run10\10_23.cypher;23;x;74;2;221
.\measurementApp\cypher\run10\10_24.cypher;24;x;74;0;221
.\measurementApp\cypher\run10\10_25.cypher;25;x;75;1;222
.\measurementApp\cypher\run10\10_26.cypher;26;x;78;11;233
.\measurementApp\cypher\run10\10_27.cypher;27;x;77;2;235
.\measurementApp\cypher\run10\10_28.cypher;28;x;79;0;235
.\measurementApp\cypher\run10\10_29.cypher;29;x;75;2;237
.\measurementApp\cypher\run10\10_30.cypher;30;x;76;4;241
.\measurementApp\cypher\run10\10_31.cypher;31;x;79;2;243
.\measurementApp\cypher\run10\10_32.cypher;32;x;76;0;243
.\measurementApp\cypher\run10\10_33.cypher;33;x;77;0;243
.\measurementApp\cypher\run10\10_34.cypher;34;x;79;2;245
.\measurementApp\cypher\run10\10_35.cypher;35;x;78;0;245
.\measurementApp\cypher\run10\10_36.cypher;36;x;77;0;245
.\measurementApp\cypher\run10\10_37.cypher;37;x;78;5;250
.\measurementApp\cypher\run10\10_38.cypher;38;x;76;4;254
.\measurementApp\cypher\run10\10_39.cypher;39;x;77;0;254
.\measurementApp\cypher\run10\10_40.cypher;40;x;79;0;254
.\measurementApp\cypher\run10\10_41.cypher;41;x;76;0;254
.\measurementApp\cypher\run10\10_42.cypher;42;x;77;0;254
.\measurementApp\cypher\run10\10_43.cypher;43;x;78;1;255
.\measurementApp\cypher\run10\10_44.cypher;44;x;79;0;255
.\measurementApp\cypher\run10\10_45.cypher;45;x;78;2;257
.\measurementApp\cypher\run10\10_46.cypher;46;x;74;4;261
.\measurementApp\cypher\run10\10_47.cypher;47;x;75;0;261
.\measurementApp\cypher\run10\10_48.cypher;48;x;74;0;261
.\measurementApp\cypher\run10\10_49.cypher;49;x;74;0;261
.\measurementApp\cypher\run10\10_50.cypher;50;x;75;0;261
Model;Index;Size;InternalDiversity;NewShapes;AllCurrentShapes
.\measurementApp\cypher\run2\2_1.cypher;1;x;68;68;68
.\measurementApp\cypher\run2\2_2.cypher;2;x;68;9;77
.\measurementApp\cypher\run2\2_3.cypher;3;x;68;7;84
.\measurementApp\cypher\run2\2_4.cypher;4;x;68;2;86
.\measurementApp\cypher\run2\2_5.cypher;5;x;68;4;90
.\measurementApp\cypher\run2\2_6.cypher;6;x;67;4;94
.\measurementApp\cypher\run2\2_7.cypher;7;x;68;4;98
.\measurementApp\cypher\run2\2_8.cypher;8;x;68;0;98
.\measurementApp\cypher\run2\2_9.cypher;9;x;68;0;98
.\measurementApp\cypher\run2\2_10.cypher;10;x;67;2;100
.\measurementApp\cypher\run2\2_11.cypher;11;x;70;28;128
.\measurementApp\cypher\run2\2_12.cypher;12;x;72;10;138
.\measurementApp\cypher\run2\2_13.cypher;13;x;70;6;144
.\measurementApp\cypher\run2\2_14.cypher;14;x;72;3;147
.\measurementApp\cypher\run2\2_15.cypher;15;x;70;0;147
.\measurementApp\cypher\run2\2_16.cypher;16;x;72;2;149
.\measurementApp\cypher\run2\2_17.cypher;17;x;75;20;169
.\measurementApp\cypher\run2\2_18.cypher;18;x;75;12;181
.\measurementApp\cypher\run2\2_19.cypher;19;x;70;6;187
.\measurementApp\cypher\run2\2_20.cypher;20;x;72;1;188
.\measurementApp\cypher\run2\2_21.cypher;21;x;69;3;191
.\measurementApp\cypher\run2\2_22.cypher;22;x;71;2;193
.\measurementApp\cypher\run2\2_23.cypher;23;x;74;3;196
.\measurementApp\cypher\run2\2_24.cypher;24;x;74;2;198
.\measurementApp\cypher\run2\2_25.cypher;25;x;67;7;205
.\measurementApp\cypher\run2\2_26.cypher;26;x;67;3;208
.\measurementApp\cypher\run2\2_27.cypher;27;x;68;0;208
.\measurementApp\cypher\run2\2_28.cypher;28;x;68;0;208
.\measurementApp\cypher\run2\2_29.cypher;29;x;68;0;208
.\measurementApp\cypher\run2\2_30.cypher;30;x;68;2;210
.\measurementApp\cypher\run2\2_31.cypher;31;x;68;0;210
.\measurementApp\cypher\run2\2_32.cypher;32;x;68;0;210
.\measurementApp\cypher\run2\2_33.cypher;33;x;68;0;210
.\measurementApp\cypher\run2\2_34.cypher;34;x;68;0;210
.\measurementApp\cypher\run2\2_35.cypher;35;x;68;3;213
.\measurementApp\cypher\run2\2_36.cypher;36;x;68;3;216
.\measurementApp\cypher\run2\2_37.cypher;37;x;68;4;220
.\measurementApp\cypher\run2\2_38.cypher;38;x;69;0;220
.\measurementApp\cypher\run2\2_39.cypher;39;x;69;0;220
.\measurementApp\cypher\run2\2_40.cypher;40;x;69;0;220
.\measurementApp\cypher\run2\2_41.cypher;41;x;69;2;222
.\measurementApp\cypher\run2\2_42.cypher;42;x;69;0;222
.\measurementApp\cypher\run2\2_43.cypher;43;x;68;0;222
.\measurementApp\cypher\run2\2_44.cypher;44;x;69;0;222
.\measurementApp\cypher\run2\2_45.cypher;45;x;70;3;225
.\measurementApp\cypher\run2\2_46.cypher;46;x;70;0;225
.\measurementApp\cypher\run2\2_47.cypher;47;x;70;5;230
.\measurementApp\cypher\run2\2_48.cypher;48;x;70;0;230
.\measurementApp\cypher\run2\2_49.cypher;49;x;70;0;230
.\measurementApp\cypher\run2\2_50.cypher;50;x;70;0;230
Model;Index;Size;InternalDiversity;NewShapes;AllCurrentShapes
.\measurementApp\cypher\run3\3_1.cypher;1;x;78;78;78
.\measurementApp\cypher\run3\3_2.cypher;2;x;78;11;89
.\measurementApp\cypher\run3\3_3.cypher;3;x;79;11;100
.\measurementApp\cypher\run3\3_4.cypher;4;x;80;15;115
.\measurementApp\cypher\run3\3_5.cypher;5;x;80;8;123
.\measurementApp\cypher\run3\3_6.cypher;6;x;79;10;133
.\measurementApp\cypher\run3\3_7.cypher;7;x;79;4;137
.\measurementApp\cypher\run3\3_8.cypher;8;x;79;6;143
.\measurementApp\cypher\run3\3_9.cypher;9;x;79;1;144
.\measurementApp\cypher\run3\3_10.cypher;10;x;80;9;153
.\measurementApp\cypher\run3\3_11.cypher;11;x;85;18;171
.\measurementApp\cypher\run3\3_12.cypher;12;x;85;10;181
.\measurementApp\cypher\run3\3_13.cypher;13;x;88;31;212
.\measurementApp\cypher\run3\3_14.cypher;14;x;87;8;220
.\measurementApp\cypher\run3\3_15.cypher;15;x;80;4;224
.\measurementApp\cypher\run3\3_16.cypher;16;x;80;0;224
.\measurementApp\cypher\run3\3_17.cypher;17;x;80;2;226
.\measurementApp\cypher\run3\3_18.cypher;18;x;80;0;226
.\measurementApp\cypher\run3\3_19.cypher;19;x;81;3;229
.\measurementApp\cypher\run3\3_20.cypher;20;x;81;0;229
.\measurementApp\cypher\run3\3_21.cypher;21;x;80;4;233
.\measurementApp\cypher\run3\3_22.cypher;22;x;80;1;234
.\measurementApp\cypher\run3\3_23.cypher;23;x;81;13;247
.\measurementApp\cypher\run3\3_24.cypher;24;x;81;5;252
.\measurementApp\cypher\run3\3_25.cypher;25;x;81;1;253
.\measurementApp\cypher\run3\3_26.cypher;26;x;81;0;253
.\measurementApp\cypher\run3\3_27.cypher;27;x;80;4;257
.\measurementApp\cypher\run3\3_28.cypher;28;x;80;0;257
.\measurementApp\cypher\run3\3_29.cypher;29;x;81;1;258
.\measurementApp\cypher\run3\3_30.cypher;30;x;81;1;259
.\measurementApp\cypher\run3\3_31.cypher;31;x;81;0;259
.\measurementApp\cypher\run3\3_32.cypher;32;x;80;0;259
.\measurementApp\cypher\run3\3_33.cypher;33;x;86;1;260
.\measurementApp\cypher\run3\3_34.cypher;34;x;86;0;260
.\measurementApp\cypher\run3\3_35.cypher;35;x;86;0;260
.\measurementApp\cypher\run3\3_36.cypher;36;x;86;6;266
.\measurementApp\cypher\run3\3_37.cypher;37;x;79;4;270
.\measurementApp\cypher\run3\3_38.cypher;38;x;79;0;270
.\measurementApp\cypher\run3\3_39.cypher;39;x;79;0;270
.\measurementApp\cypher\run3\3_40.cypher;40;x;80;1;271
.\measurementApp\cypher\run3\3_41.cypher;41;x;79;0;271
.\measurementApp\cypher\run3\3_42.cypher;42;x;80;13;284
.\measurementApp\cypher\run3\3_43.cypher;43;x;80;4;288
.\measurementApp\cypher\run3\3_44.cypher;44;x;81;2;290
.\measurementApp\cypher\run3\3_45.cypher;45;x;80;2;292
.\measurementApp\cypher\run3\3_46.cypher;46;x;80;2;294
.\measurementApp\cypher\run3\3_47.cypher;47;x;80;0;294
.\measurementApp\cypher\run3\3_48.cypher;48;x;81;0;294
.\measurementApp\cypher\run3\3_49.cypher;49;x;80;4;298
.\measurementApp\cypher\run3\3_50.cypher;50;x;81;2;300
Model;Index;Size;InternalDiversity;NewShapes;AllCurrentShapes
.\measurementApp\cypher\run4\4_1.cypher;1;x;68;68;68
.\measurementApp\cypher\run4\4_2.cypher;2;x;68;12;80
.\measurementApp\cypher\run4\4_3.cypher;3;x;69;7;87
.\measurementApp\cypher\run4\4_4.cypher;4;x;69;1;88
.\measurementApp\cypher\run4\4_5.cypher;5;x;69;0;88
.\measurementApp\cypher\run4\4_6.cypher;6;x;69;9;97
.\measurementApp\cypher\run4\4_7.cypher;7;x;68;4;101
.\measurementApp\cypher\run4\4_8.cypher;8;x;68;0;101
.\measurementApp\cypher\run4\4_9.cypher;9;x;68;0;101
.\measurementApp\cypher\run4\4_10.cypher;10;x;68;0;101
.\measurementApp\cypher\run4\4_11.cypher;11;x;69;4;105
.\measurementApp\cypher\run4\4_12.cypher;12;x;69;2;107
.\measurementApp\cypher\run4\4_13.cypher;13;x;68;4;111
.\measurementApp\cypher\run4\4_14.cypher;14;x;68;0;111
.\measurementApp\cypher\run4\4_15.cypher;15;x;68;0;111
.\measurementApp\cypher\run4\4_16.cypher;16;x;68;0;111
.\measurementApp\cypher\run4\4_17.cypher;17;x;69;4;115
.\measurementApp\cypher\run4\4_18.cypher;18;x;69;2;117
.\measurementApp\cypher\run4\4_19.cypher;19;x;69;0;117
.\measurementApp\cypher\run4\4_20.cypher;20;x;69;0;117
.\measurementApp\cypher\run4\4_21.cypher;21;x;69;2;119
.\measurementApp\cypher\run4\4_22.cypher;22;x;69;2;121
.\measurementApp\cypher\run4\4_23.cypher;23;x;71;17;138
.\measurementApp\cypher\run4\4_24.cypher;24;x;73;3;141
.\measurementApp\cypher\run4\4_25.cypher;25;x;71;0;141
.\measurementApp\cypher\run4\4_26.cypher;26;x;73;10;151
.\measurementApp\cypher\run4\4_27.cypher;27;x;73;9;160
.\measurementApp\cypher\run4\4_28.cypher;28;x;73;0;160
.\measurementApp\cypher\run4\4_29.cypher;29;x;72;3;163
.\measurementApp\cypher\run4\4_30.cypher;30;x;72;2;165
.\measurementApp\cypher\run4\4_31.cypher;31;x;72;6;171
.\measurementApp\cypher\run4\4_32.cypher;32;x;70;4;175
.\measurementApp\cypher\run4\4_33.cypher;33;x;71;4;179
.\measurementApp\cypher\run4\4_34.cypher;34;x;71;9;188
.\measurementApp\cypher\run4\4_35.cypher;35;x;71;0;188
.\measurementApp\cypher\run4\4_36.cypher;36;x;71;2;190
.\measurementApp\cypher\run4\4_37.cypher;37;x;70;4;194
.\measurementApp\cypher\run4\4_38.cypher;38;x;70;0;194
.\measurementApp\cypher\run4\4_39.cypher;39;x;70;1;195
.\measurementApp\cypher\run4\4_40.cypher;40;x;70;0;195
.\measurementApp\cypher\run4\4_41.cypher;41;x;71;2;197
.\measurementApp\cypher\run4\4_42.cypher;42;x;71;2;199
.\measurementApp\cypher\run4\4_43.cypher;43;x;70;3;202
.\measurementApp\cypher\run4\4_44.cypher;44;x;70;6;208
.\measurementApp\cypher\run4\4_45.cypher;45;x;71;0;208
.\measurementApp\cypher\run4\4_46.cypher;46;x;71;1;209
.\measurementApp\cypher\run4\4_47.cypher;47;x;71;0;209
.\measurementApp\cypher\run4\4_48.cypher;48;x;71;0;209
.\measurementApp\cypher\run4\4_49.cypher;49;x;71;0;209
.\measurementApp\cypher\run4\4_50.cypher;50;x;71;2;211
Model;Index;Size;InternalDiversity;NewShapes;AllCurrentShapes
.\measurementApp\cypher\run5\5_1.cypher;1;x;71;71;71
.\measurementApp\cypher\run5\5_2.cypher;2;x;69;12;83
.\measurementApp\cypher\run5\5_3.cypher;3;x;74;18;101
.\measurementApp\cypher\run5\5_4.cypher;4;x;74;12;113
.\measurementApp\cypher\run5\5_5.cypher;5;x;78;17;130
.\measurementApp\cypher\run5\5_6.cypher;6;x;78;12;142
.\measurementApp\cypher\run5\5_7.cypher;7;x;78;4;146
.\measurementApp\cypher\run5\5_8.cypher;8;x;78;12;158
.\measurementApp\cypher\run5\5_9.cypher;9;x;78;3;161
.\measurementApp\cypher\run5\5_10.cypher;10;x;78;3;164
.\measurementApp\cypher\run5\5_11.cypher;11;x;77;6;170
.\measurementApp\cypher\run5\5_12.cypher;12;x;75;7;177
.\measurementApp\cypher\run5\5_13.cypher;13;x;75;0;177
.\measurementApp\cypher\run5\5_14.cypher;14;x;75;4;181
.\measurementApp\cypher\run5\5_15.cypher;15;x;75;1;182
.\measurementApp\cypher\run5\5_16.cypher;16;x;75;0;182
.\measurementApp\cypher\run5\5_17.cypher;17;x;75;0;182
.\measurementApp\cypher\run5\5_18.cypher;18;x;75;1;183
.\measurementApp\cypher\run5\5_19.cypher;19;x;75;0;183
.\measurementApp\cypher\run5\5_20.cypher;20;x;74;4;187
.\measurementApp\cypher\run5\5_21.cypher;21;x;74;2;189
.\measurementApp\cypher\run5\5_22.cypher;22;x;75;4;193
.\measurementApp\cypher\run5\5_23.cypher;23;x;75;2;195
.\measurementApp\cypher\run5\5_24.cypher;24;x;75;4;199
.\measurementApp\cypher\run5\5_25.cypher;25;x;75;0;199
.\measurementApp\cypher\run5\5_26.cypher;26;x;75;0;199
.\measurementApp\cypher\run5\5_27.cypher;27;x;75;0;199
.\measurementApp\cypher\run5\5_28.cypher;28;x;75;0;199
.\measurementApp\cypher\run5\5_29.cypher;29;x;75;0;199
.\measurementApp\cypher\run5\5_30.cypher;30;x;75;0;199
.\measurementApp\cypher\run5\5_31.cypher;31;x;75;0;199
.\measurementApp\cypher\run5\5_32.cypher;32;x;75;0;199
.\measurementApp\cypher\run5\5_33.cypher;33;x;75;0;199
.\measurementApp\cypher\run5\5_34.cypher;34;x;75;2;201
.\measurementApp\cypher\run5\5_35.cypher;35;x;75;0;201
.\measurementApp\cypher\run5\5_36.cypher;36;x;74;2;203
.\measurementApp\cypher\run5\5_37.cypher;37;x;74;2;205
.\measurementApp\cypher\run5\5_38.cypher;38;x;74;0;205
.\measurementApp\cypher\run5\5_39.cypher;39;x;74;0;205
.\measurementApp\cypher\run5\5_40.cypher;40;x;75;2;207
.\measurementApp\cypher\run5\5_41.cypher;41;x;75;0;207
.\measurementApp\cypher\run5\5_42.cypher;42;x;76;3;210
.\measurementApp\cypher\run5\5_43.cypher;43;x;76;0;210
.\measurementApp\cypher\run5\5_44.cypher;44;x;76;0;210
.\measurementApp\cypher\run5\5_45.cypher;45;x;79;1;211
.\measurementApp\cypher\run5\5_46.cypher;46;x;76;0;211
.\measurementApp\cypher\run5\5_47.cypher;47;x;76;0;211
.\measurementApp\cypher\run5\5_48.cypher;48;x;76;0;211
.\measurementApp\cypher\run5\5_49.cypher;49;x;78;7;218
.\measurementApp\cypher\run5\5_50.cypher;50;x;76;0;218
Model;Index;Size;InternalDiversity;NewShapes;AllCurrentShapes
.\measurementApp\cypher\run6\6_1.cypher;1;x;71;71;71
.\measurementApp\cypher\run6\6_2.cypher;2;x;69;12;83
.\measurementApp\cypher\run6\6_3.cypher;3;x;74;18;101
.\measurementApp\cypher\run6\6_4.cypher;4;x;74;12;113
.\measurementApp\cypher\run6\6_5.cypher;5;x;78;27;140
.\measurementApp\cypher\run6\6_6.cypher;6;x;77;9;149
.\measurementApp\cypher\run6\6_7.cypher;7;x;78;12;161
.\measurementApp\cypher\run6\6_8.cypher;8;x;78;2;163
.\measurementApp\cypher\run6\6_9.cypher;9;x;78;2;165
.\measurementApp\cypher\run6\6_10.cypher;10;x;79;7;172
.\measurementApp\cypher\run6\6_11.cypher;11;x;79;6;178
.\measurementApp\cypher\run6\6_12.cypher;12;x;79;4;182
.\measurementApp\cypher\run6\6_13.cypher;13;x;79;2;184
.\measurementApp\cypher\run6\6_14.cypher;14;x;78;4;188
.\measurementApp\cypher\run6\6_15.cypher;15;x;78;0;188
.\measurementApp\cypher\run6\6_16.cypher;16;x;79;4;192
.\measurementApp\cypher\run6\6_17.cypher;17;x;79;0;192
.\measurementApp\cypher\run6\6_18.cypher;18;x;79;4;196
.\measurementApp\cypher\run6\6_19.cypher;19;x;79;2;198
.\measurementApp\cypher\run6\6_20.cypher;20;x;75;0;198
.\measurementApp\cypher\run6\6_21.cypher;21;x;75;3;201
.\measurementApp\cypher\run6\6_22.cypher;22;x;75;0;201
.\measurementApp\cypher\run6\6_23.cypher;23;x;75;2;203
.\measurementApp\cypher\run6\6_24.cypher;24;x;75;2;205
.\measurementApp\cypher\run6\6_25.cypher;25;x;75;2;207
.\measurementApp\cypher\run6\6_26.cypher;26;x;75;0;207
.\measurementApp\cypher\run6\6_27.cypher;27;x;75;2;209
.\measurementApp\cypher\run6\6_28.cypher;28;x;74;0;209
.\measurementApp\cypher\run6\6_29.cypher;29;x;74;0;209
.\measurementApp\cypher\run6\6_30.cypher;30;x;74;0;209
.\measurementApp\cypher\run6\6_31.cypher;31;x;74;0;209
.\measurementApp\cypher\run6\6_32.cypher;32;x;75;1;210
.\measurementApp\cypher\run6\6_33.cypher;33;x;75;0;210
.\measurementApp\cypher\run6\6_34.cypher;34;x;75;1;211
.\measurementApp\cypher\run6\6_35.cypher;35;x;75;0;211
.\measurementApp\cypher\run6\6_36.cypher;36;x;75;0;211
.\measurementApp\cypher\run6\6_37.cypher;37;x;75;0;211
.\measurementApp\cypher\run6\6_38.cypher;38;x;75;1;212
.\measurementApp\cypher\run6\6_39.cypher;39;x;75;0;212
.\measurementApp\cypher\run6\6_40.cypher;40;x;79;0;212
.\measurementApp\cypher\run6\6_41.cypher;41;x;79;7;219
.\measurementApp\cypher\run6\6_42.cypher;42;x;79;0;219
.\measurementApp\cypher\run6\6_43.cypher;43;x;79;0;219
.\measurementApp\cypher\run6\6_44.cypher;44;x;79;5;224
.\measurementApp\cypher\run6\6_45.cypher;45;x;80;0;224
.\measurementApp\cypher\run6\6_46.cypher;46;x;80;0;224
.\measurementApp\cypher\run6\6_47.cypher;47;x;80;0;224
.\measurementApp\cypher\run6\6_48.cypher;48;x;80;0;224
.\measurementApp\cypher\run6\6_49.cypher;49;x;79;0;224
.\measurementApp\cypher\run6\6_50.cypher;50;x;79;0;224
Model;Index;Size;InternalDiversity;NewShapes;AllCurrentShapes
.\measurementApp\cypher\run7\7_1.cypher;1;x;77;77;77
.\measurementApp\cypher\run7\7_2.cypher;2;x;78;32;109
.\measurementApp\cypher\run7\7_3.cypher;3;x;79;11;120
.\measurementApp\cypher\run7\7_4.cypher;4;x;79;9;129
.\measurementApp\cypher\run7\7_5.cypher;5;x;80;16;145
.\measurementApp\cypher\run7\7_6.cypher;6;x;79;8;153
.\measurementApp\cypher\run7\7_7.cypher;7;x;80;3;156
.\measurementApp\cypher\run7\7_8.cypher;8;x;80;4;160
.\measurementApp\cypher\run7\7_9.cypher;9;x;79;14;174
.\measurementApp\cypher\run7\7_10.cypher;10;x;79;0;174
.\measurementApp\cypher\run7\7_11.cypher;11;x;79;0;174
.\measurementApp\cypher\run7\7_12.cypher;12;x;79;0;174
.\measurementApp\cypher\run7\7_13.cypher;13;x;78;4;178
.\measurementApp\cypher\run7\7_14.cypher;14;x;78;6;184
.\measurementApp\cypher\run7\7_15.cypher;15;x;78;0;184
.\measurementApp\cypher\run7\7_16.cypher;16;x;78;6;190
.\measurementApp\cypher\run7\7_17.cypher;17;x;81;8;198
.\measurementApp\cypher\run7\7_18.cypher;18;x;81;0;198
.\measurementApp\cypher\run7\7_19.cypher;19;x;81;6;204
.\measurementApp\cypher\run7\7_20.cypher;20;x;81;4;208
.\measurementApp\cypher\run7\7_21.cypher;21;x;81;0;208
.\measurementApp\cypher\run7\7_22.cypher;22;x;81;0;208
.\measurementApp\cypher\run7\7_23.cypher;23;x;78;4;212
.\measurementApp\cypher\run7\7_24.cypher;24;x;78;2;214
.\measurementApp\cypher\run7\7_25.cypher;25;x;77;4;218
.\measurementApp\cypher\run7\7_26.cypher;26;x;77;0;218
.\measurementApp\cypher\run7\7_27.cypher;27;x;77;0;218
.\measurementApp\cypher\run7\7_28.cypher;28;x;77;0;218
.\measurementApp\cypher\run7\7_29.cypher;29;x;79;4;222
.\measurementApp\cypher\run7\7_30.cypher;30;x;79;0;222
.\measurementApp\cypher\run7\7_31.cypher;31;x;78;1;223
.\measurementApp\cypher\run7\7_32.cypher;32;x;78;0;223
.\measurementApp\cypher\run7\7_33.cypher;33;x;78;0;223
.\measurementApp\cypher\run7\7_34.cypher;34;x;78;4;227
.\measurementApp\cypher\run7\7_35.cypher;35;x;79;4;231
.\measurementApp\cypher\run7\7_36.cypher;36;x;79;2;233
.\measurementApp\cypher\run7\7_37.cypher;37;x;79;4;237
.\measurementApp\cypher\run7\7_38.cypher;38;x;78;2;239
.\measurementApp\cypher\run7\7_39.cypher;39;x;86;10;249
.\measurementApp\cypher\run7\7_40.cypher;40;x;86;7;256
.\measurementApp\cypher\run7\7_41.cypher;41;x;86;7;263
.\measurementApp\cypher\run7\7_42.cypher;42;x;86;0;263
.\measurementApp\cypher\run7\7_43.cypher;43;x;86;4;267
.\measurementApp\cypher\run7\7_44.cypher;44;x;86;0;267
.\measurementApp\cypher\run7\7_45.cypher;45;x;87;1;268
.\measurementApp\cypher\run7\7_46.cypher;46;x;87;0;268
.\measurementApp\cypher\run7\7_47.cypher;47;x;86;4;272
.\measurementApp\cypher\run7\7_48.cypher;48;x;87;1;273
.\measurementApp\cypher\run7\7_49.cypher;49;x;87;2;275
.\measurementApp\cypher\run7\7_50.cypher;50;x;87;2;277
Model;Index;Size;InternalDiversity;NewShapes;AllCurrentShapes
.\measurementApp\cypher\run8\8_1.cypher;1;x;75;75;75
.\measurementApp\cypher\run8\8_2.cypher;2;x;75;9;84
.\measurementApp\cypher\run8\8_3.cypher;3;x;77;15;99
.\measurementApp\cypher\run8\8_4.cypher;4;x;77;0;99
.\measurementApp\cypher\run8\8_5.cypher;5;x;79;18;117
.\measurementApp\cypher\run8\8_6.cypher;6;x;79;3;120
.\measurementApp\cypher\run8\8_7.cypher;7;x;80;1;121
.\measurementApp\cypher\run8\8_8.cypher;8;x;80;9;130
.\measurementApp\cypher\run8\8_9.cypher;9;x;79;0;130
.\measurementApp\cypher\run8\8_10.cypher;10;x;80;12;142
.\measurementApp\cypher\run8\8_11.cypher;11;x;79;28;170
.\measurementApp\cypher\run8\8_12.cypher;12;x;79;9;179
.\measurementApp\cypher\run8\8_13.cypher;13;x;80;12;191
.\measurementApp\cypher\run8\8_14.cypher;14;x;85;11;202
.\measurementApp\cypher\run8\8_15.cypher;15;x;85;10;212
.\measurementApp\cypher\run8\8_16.cypher;16;x;85;8;220
.\measurementApp\cypher\run8\8_17.cypher;17;x;85;5;225
.\measurementApp\cypher\run8\8_18.cypher;18;x;85;2;227
.\measurementApp\cypher\run8\8_19.cypher;19;x;85;1;228
.\measurementApp\cypher\run8\8_20.cypher;20;x;83;4;232
.\measurementApp\cypher\run8\8_21.cypher;21;x;85;3;235
.\measurementApp\cypher\run8\8_22.cypher;22;x;83;0;235
.\measurementApp\cypher\run8\8_23.cypher;23;x;85;1;236
.\measurementApp\cypher\run8\8_24.cypher;24;x;83;1;237
.\measurementApp\cypher\run8\8_25.cypher;25;x;83;0;237
.\measurementApp\cypher\run8\8_26.cypher;26;x;83;0;237
.\measurementApp\cypher\run8\8_27.cypher;27;x;83;0;237
.\measurementApp\cypher\run8\8_28.cypher;28;x;80;7;244
.\measurementApp\cypher\run8\8_29.cypher;29;x;81;0;244
.\measurementApp\cypher\run8\8_30.cypher;30;x;80;0;244
.\measurementApp\cypher\run8\8_31.cypher;31;x;81;0;244
.\measurementApp\cypher\run8\8_32.cypher;32;x;87;18;262
.\measurementApp\cypher\run8\8_33.cypher;33;x;87;5;267
.\measurementApp\cypher\run8\8_34.cypher;34;x;80;4;271
.\measurementApp\cypher\run8\8_35.cypher;35;x;80;2;273
.\measurementApp\cypher\run8\8_36.cypher;36;x;81;0;273
.\measurementApp\cypher\run8\8_37.cypher;37;x;81;2;275
.\measurementApp\cypher\run8\8_38.cypher;38;x;81;4;279
.\measurementApp\cypher\run8\8_39.cypher;39;x;81;2;281
.\measurementApp\cypher\run8\8_40.cypher;40;x;79;4;285
.\measurementApp\cypher\run8\8_41.cypher;41;x;79;0;285
.\measurementApp\cypher\run8\8_42.cypher;42;x;80;0;285
.\measurementApp\cypher\run8\8_43.cypher;43;x;80;0;285
.\measurementApp\cypher\run8\8_44.cypher;44;x;80;11;296
.\measurementApp\cypher\run8\8_45.cypher;45;x;80;2;298
.\measurementApp\cypher\run8\8_46.cypher;46;x;80;4;302
.\measurementApp\cypher\run8\8_47.cypher;47;x;80;0;302
.\measurementApp\cypher\run8\8_48.cypher;48;x;81;7;309
.\measurementApp\cypher\run8\8_49.cypher;49;x;81;0;309
.\measurementApp\cypher\run8\8_50.cypher;50;x;80;2;311
Model;Index;Size;InternalDiversity;NewShapes;AllCurrentShapes
.\measurementApp\cypher\run9\9_1.cypher;1;x;71;71;71
.\measurementApp\cypher\run9\9_2.cypher;2;x;71;9;80
.\measurementApp\cypher\run9\9_3.cypher;3;x;74;25;105
.\measurementApp\cypher\run9\9_4.cypher;4;x;75;7;112
.\measurementApp\cypher\run9\9_5.cypher;5;x;75;12;124
.\measurementApp\cypher\run9\9_6.cypher;6;x;75;9;133
.\measurementApp\cypher\run9\9_7.cypher;7;x;78;11;144
.\measurementApp\cypher\run9\9_8.cypher;8;x;78;6;150
.\measurementApp\cypher\run9\9_9.cypher;9;x;75;0;150
.\measurementApp\cypher\run9\9_10.cypher;10;x;78;9;159
.\measurementApp\cypher\run9\9_11.cypher;11;x;75;4;163
.\measurementApp\cypher\run9\9_12.cypher;12;x;75;0;163
.\measurementApp\cypher\run9\9_13.cypher;13;x;75;0;163
.\measurementApp\cypher\run9\9_14.cypher;14;x;75;0;163
.\measurementApp\cypher\run9\9_15.cypher;15;x;75;4;167
.\measurementApp\cypher\run9\9_16.cypher;16;x;75;0;167
.\measurementApp\cypher\run9\9_17.cypher;17;x;75;0;167
.\measurementApp\cypher\run9\9_18.cypher;18;x;75;0;167
.\measurementApp\cypher\run9\9_19.cypher;19;x;74;4;171
.\measurementApp\cypher\run9\9_20.cypher;20;x;74;0;171
.\measurementApp\cypher\run9\9_21.cypher;21;x;75;4;175
.\measurementApp\cypher\run9\9_22.cypher;22;x;75;2;177
.\measurementApp\cypher\run9\9_23.cypher;23;x;75;2;179
.\measurementApp\cypher\run9\9_24.cypher;24;x;75;0;179
.\measurementApp\cypher\run9\9_25.cypher;25;x;74;1;180
.\measurementApp\cypher\run9\9_26.cypher;26;x;74;0;180
.\measurementApp\cypher\run9\9_27.cypher;27;x;79;9;189
.\measurementApp\cypher\run9\9_28.cypher;28;x;79;2;191
.\measurementApp\cypher\run9\9_29.cypher;29;x;79;0;191
.\measurementApp\cypher\run9\9_30.cypher;30;x;78;8;199
.\measurementApp\cypher\run9\9_31.cypher;31;x;79;0;199
.\measurementApp\cypher\run9\9_32.cypher;32;x;78;7;206
.\measurementApp\cypher\run9\9_33.cypher;33;x;80;4;210
.\measurementApp\cypher\run9\9_34.cypher;34;x;79;0;210
.\measurementApp\cypher\run9\9_35.cypher;35;x;80;0;210
.\measurementApp\cypher\run9\9_36.cypher;36;x;79;7;217
.\measurementApp\cypher\run9\9_37.cypher;37;x;79;4;221
.\measurementApp\cypher\run9\9_38.cypher;38;x;79;2;223
.\measurementApp\cypher\run9\9_39.cypher;39;x;78;0;223
.\measurementApp\cypher\run9\9_40.cypher;40;x;78;2;225
.\measurementApp\cypher\run9\9_41.cypher;41;x;80;2;227
.\measurementApp\cypher\run9\9_42.cypher;42;x;79;0;227
.\measurementApp\cypher\run9\9_43.cypher;43;x;80;0;227
.\measurementApp\cypher\run9\9_44.cypher;44;x;79;2;229
.\measurementApp\cypher\run9\9_45.cypher;45;x;80;1;230
.\measurementApp\cypher\run9\9_46.cypher;46;x;79;1;231
.\measurementApp\cypher\run9\9_47.cypher;47;x;80;0;231
.\measurementApp\cypher\run9\9_48.cypher;48;x;79;0;231
.\measurementApp\cypher\run9\9_49.cypher;49;x;79;1;232
.\measurementApp\cypher\run9\9_50.cypher;50;x;78;1;233
Model;Index;Size;InternalDiversity;NewShapes;AllCurrentShapes
.\measurementA\cypher\run\12_1.cypher;1;x;56;56;56
.\measurementA\cypher\run\12_2.cypher;2;x;58;15;71
.\measurementA\cypher\run\12_3.cypher;3;x;55;5;76
.\measurementA\cypher\run\12_4.cypher;4;x;56;6;82
.\measurementA\cypher\run\12_5.cypher;5;x;58;9;91
.\measurementA\cypher\run\12_6.cypher;6;x;58;2;93
.\measurementA\cypher\run\12_7.cypher;7;x;59;8;101
.\measurementA\cypher\run\12_8.cypher;8;x;58;9;110
.\measurementA\cypher\run\12_9.cypher;9;x;57;5;115
.\measurementA\cypher\run\12_10.cypher;10;x;56;6;121
.\measurementA\cypher\run\12_11.cypher;11;x;57;0;121
.\measurementA\cypher\run\12_12.cypher;12;x;56;0;121
.\measurementA\cypher\run\12_13.cypher;13;x;59;0;121
.\measurementA\cypher\run\12_14.cypher;14;x;58;0;121
.\measurementA\cypher\run\12_15.cypher;15;x;59;3;124
.\measurementA\cypher\run\12_16.cypher;16;x;57;3;127
.\measurementA\cypher\run\12_17.cypher;17;x;60;14;141
.\measurementA\cypher\run\12_18.cypher;18;x;62;1;142
.\measurementA\cypher\run\12_19.cypher;19;x;61;1;143
.\measurementA\cypher\run\12_20.cypher;20;x;63;0;143
.\measurementA\cypher\run\12_21.cypher;21;x;63;9;152
.\measurementA\cypher\run\12_22.cypher;22;x;61;4;156
.\measurementA\cypher\run\12_23.cypher;23;x;61;12;168
.\measurementA\cypher\run\12_24.cypher;24;x;63;8;176
.\measurementA\cypher\run\12_25.cypher;25;x;59;5;181
.\measurementA\cypher\run\12_26.cypher;26;x;60;0;181
.\measurementA\cypher\run\12_27.cypher;27;x;61;1;182
.\measurementA\cypher\run\12_28.cypher;28;x;62;1;183
.\measurementA\cypher\run\12_29.cypher;29;x;61;2;185
.\measurementA\cypher\run\12_30.cypher;30;x;63;1;186
.\measurementA\cypher\run\12_31.cypher;31;x;59;0;186
.\measurementA\cypher\run\12_32.cypher;32;x;61;0;186
.\measurementA\cypher\run\12_33.cypher;33;x;60;0;186
.\measurementA\cypher\run\12_34.cypher;34;x;62;0;186
.\measurementA\cypher\run\12_35.cypher;35;x;61;0;186
.\measurementA\cypher\run\12_36.cypher;36;x;60;0;186
.\measurementA\cypher\run\12_37.cypher;37;x;60;1;187
.\measurementA\cypher\run\12_38.cypher;38;x;62;0;187
.\measurementA\cypher\run\12_39.cypher;39;x;63;0;187
.\measurementA\cypher\run\12_40.cypher;40;x;61;0;187
.\measurementA\cypher\run\12_41.cypher;41;x;63;0;187
.\measurementA\cypher\run\12_42.cypher;42;x;63;7;194
.\measurementA\cypher\run\12_43.cypher;43;x;61;5;199
.\measurementA\cypher\run\12_44.cypher;44;x;63;1;200
.\measurementA\cypher\run\12_45.cypher;45;x;63;2;202
.\measurementA\cypher\run\12_46.cypher;46;x;62;0;202
.\measurementA\cypher\run\12_47.cypher;47;x;61;2;204
.\measurementA\cypher\run\12_48.cypher;48;x;63;1;205
.\measurementA\cypher\run\12_49.cypher;49;x;61;0;205
.\measurementA\cypher\run\12_50.cypher;50;x;63;0;205
Model;Index;Size;InternalDiversity;NewShapes;AllCurrentShapes
.\measurementA\cypher\run1\1_1.cypher;1;x;57;57;57
.\measurementA\cypher\run1\1_2.cypher;2;x;57;12;69
.\measurementA\cypher\run1\1_3.cypher;3;x;59;16;85
.\measurementA\cypher\run1\1_4.cypher;4;x;58;0;85
.\measurementA\cypher\run1\1_5.cypher;5;x;58;0;85
.\measurementA\cypher\run1\1_6.cypher;6;x;56;5;90
.\measurementA\cypher\run1\1_7.cypher;7;x;59;6;96
.\measurementA\cypher\run1\1_8.cypher;8;x;56;0;96
.\measurementA\cypher\run1\1_9.cypher;9;x;57;5;101
.\measurementA\cypher\run1\1_10.cypher;10;x;60;0;101
.\measurementA\cypher\run1\1_11.cypher;11;x;60;0;101
.\measurementA\cypher\run1\1_12.cypher;12;x;57;0;101
.\measurementA\cypher\run1\1_13.cypher;13;x;58;6;107
.\measurementA\cypher\run1\1_14.cypher;14;x;58;0;107
.\measurementA\cypher\run1\1_15.cypher;15;x;59;4;111
.\measurementA\cypher\run1\1_16.cypher;16;x;59;0;111
.\measurementA\cypher\run1\1_17.cypher;17;x;57;10;121
.\measurementA\cypher\run1\1_18.cypher;18;x;57;7;128
.\measurementA\cypher\run1\1_19.cypher;19;x;59;6;134
.\measurementA\cypher\run1\1_20.cypher;20;x;58;0;134
.\measurementA\cypher\run1\1_21.cypher;21;x;59;8;142
.\measurementA\cypher\run1\1_22.cypher;22;x;56;0;142
.\measurementA\cypher\run1\1_23.cypher;23;x;57;0;142
.\measurementA\cypher\run1\1_24.cypher;24;x;56;0;142
.\measurementA\cypher\run1\1_25.cypher;25;x;58;0;142
.\measurementA\cypher\run1\1_26.cypher;26;x;58;0;142
.\measurementA\cypher\run1\1_27.cypher;27;x;57;0;142
.\measurementA\cypher\run1\1_28.cypher;28;x;59;0;142
.\measurementA\cypher\run1\1_29.cypher;29;x;60;0;142
.\measurementA\cypher\run1\1_30.cypher;30;x;59;0;142
.\measurementA\cypher\run1\1_31.cypher;31;x;57;0;142
.\measurementA\cypher\run1\1_32.cypher;32;x;59;0;142
.\measurementA\cypher\run1\1_33.cypher;33;x;58;7;149
.\measurementA\cypher\run1\1_34.cypher;34;x;59;0;149
.\measurementA\cypher\run1\1_35.cypher;35;x;58;0;149
.\measurementA\cypher\run1\1_36.cypher;36;x;57;0;149
.\measurementA\cypher\run1\1_37.cypher;37;x;58;0;149
.\measurementA\cypher\run1\1_38.cypher;38;x;60;4;153
.\measurementA\cypher\run1\1_39.cypher;39;x;60;0;153
.\measurementA\cypher\run1\1_40.cypher;40;x;61;0;153
.\measurementA\cypher\run1\1_41.cypher;41;x;58;1;154
.\measurementA\cypher\run1\1_42.cypher;42;x;58;0;154
.\measurementA\cypher\run1\1_43.cypher;43;x;59;0;154
.\measurementA\cypher\run1\1_44.cypher;44;x;60;0;154
.\measurementA\cypher\run1\1_45.cypher;45;x;58;0;154
.\measurementA\cypher\run1\1_46.cypher;46;x;58;0;154
.\measurementA\cypher\run1\1_47.cypher;47;x;57;0;154
.\measurementA\cypher\run1\1_48.cypher;48;x;60;0;154
.\measurementA\cypher\run1\1_49.cypher;49;x;57;0;154
.\measurementA\cypher\run1\1_50.cypher;50;x;59;0;154
Model;Index;Size;InternalDiversity;NewShapes;AllCurrentShapes
.\measurementA\cypher\run10\10_1.cypher;1;x;56;56;56
.\measurementA\cypher\run10\10_2.cypher;2;x;57;15;71
.\measurementA\cypher\run10\10_3.cypher;3;x;56;0;71
.\measurementA\cypher\run10\10_4.cypher;4;x;55;0;71
.\measurementA\cypher\run10\10_5.cypher;5;x;58;15;86
.\measurementA\cypher\run10\10_6.cypher;6;x;59;9;95
.\measurementA\cypher\run10\10_7.cypher;7;x;60;11;106
.\measurementA\cypher\run10\10_8.cypher;8;x;57;7;113
.\measurementA\cypher\run10\10_9.cypher;9;x;56;5;118
.\measurementA\cypher\run10\10_10.cypher;10;x;58;0;118
.\measurementA\cypher\run10\10_11.cypher;11;x;57;0;118
.\measurementA\cypher\run10\10_12.cypher;12;x;57;0;118
.\measurementA\cypher\run10\10_13.cypher;13;x;56;0;118
.\measurementA\cypher\run10\10_14.cypher;14;x;58;0;118
.\measurementA\cypher\run10\10_15.cypher;15;x;57;0;118
.\measurementA\cypher\run10\10_16.cypher;16;x;57;0;118
.\measurementA\cypher\run10\10_17.cypher;17;x;59;1;119
.\measurementA\cypher\run10\10_18.cypher;18;x;58;6;125
.\measurementA\cypher\run10\10_19.cypher;19;x;59;0;125
.\measurementA\cypher\run10\10_20.cypher;20;x;57;3;128
.\measurementA\cypher\run10\10_21.cypher;21;x;59;0;128
.\measurementA\cypher\run10\10_22.cypher;22;x;58;0;128
.\measurementA\cypher\run10\10_23.cypher;23;x;59;3;131
.\measurementA\cypher\run10\10_24.cypher;24;x;59;0;131
.\measurementA\cypher\run10\10_25.cypher;25;x;60;14;145
.\measurementA\cypher\run10\10_26.cypher;26;x;62;0;145
.\measurementA\cypher\run10\10_27.cypher;27;x;61;0;145
.\measurementA\cypher\run10\10_28.cypher;28;x;59;0;145
.\measurementA\cypher\run10\10_29.cypher;29;x;60;5;150
.\measurementA\cypher\run10\10_30.cypher;30;x;60;6;156
.\measurementA\cypher\run10\10_31.cypher;31;x;62;2;158
.\measurementA\cypher\run10\10_32.cypher;32;x;59;0;158
.\measurementA\cypher\run10\10_33.cypher;33;x;61;0;158
.\measurementA\cypher\run10\10_34.cypher;34;x;60;0;158
.\measurementA\cypher\run10\10_35.cypher;35;x;62;0;158
.\measurementA\cypher\run10\10_36.cypher;36;x;62;3;161
.\measurementA\cypher\run10\10_37.cypher;37;x;60;13;174
.\measurementA\cypher\run10\10_38.cypher;38;x;62;0;174
.\measurementA\cypher\run10\10_39.cypher;39;x;60;0;174
.\measurementA\cypher\run10\10_40.cypher;40;x;62;9;183
.\measurementA\cypher\run10\10_41.cypher;41;x;62;4;187
.\measurementA\cypher\run10\10_42.cypher;42;x;61;0;187
.\measurementA\cypher\run10\10_43.cypher;43;x;62;0;187
.\measurementA\cypher\run10\10_44.cypher;44;x;61;0;187
.\measurementA\cypher\run10\10_45.cypher;45;x;63;2;189
.\measurementA\cypher\run10\10_46.cypher;46;x;62;0;189
.\measurementA\cypher\run10\10_47.cypher;47;x;62;0;189
.\measurementA\cypher\run10\10_48.cypher;48;x;62;0;189
.\measurementA\cypher\run10\10_49.cypher;49;x;63;1;190
.\measurementA\cypher\run10\10_50.cypher;50;x;63;0;190
Model;Index;Size;InternalDiversity;NewShapes;AllCurrentShapes
.\measurementA\cypher\run2\2_1.cypher;1;x;55;55;55
.\measurementA\cypher\run2\2_2.cypher;2;x;53;5;60
.\measurementA\cypher\run2\2_3.cypher;3;x;55;9;69
.\measurementA\cypher\run2\2_4.cypher;4;x;56;13;82
.\measurementA\cypher\run2\2_5.cypher;5;x;58;3;85
.\measurementA\cypher\run2\2_6.cypher;6;x;57;7;92
.\measurementA\cypher\run2\2_7.cypher;7;x;59;1;93
.\measurementA\cypher\run2\2_8.cypher;8;x;58;12;105
.\measurementA\cypher\run2\2_9.cypher;9;x;62;3;108
.\measurementA\cypher\run2\2_10.cypher;10;x;62;5;113
.\measurementA\cypher\run2\2_11.cypher;11;x;62;8;121
.\measurementA\cypher\run2\2_12.cypher;12;x;65;8;129
.\measurementA\cypher\run2\2_13.cypher;13;x;65;1;130
.\measurementA\cypher\run2\2_14.cypher;14;x;65;5;135
.\measurementA\cypher\run2\2_15.cypher;15;x;63;7;142
.\measurementA\cypher\run2\2_16.cypher;16;x;63;0;142
.\measurementA\cypher\run2\2_17.cypher;17;x;63;0;142
.\measurementA\cypher\run2\2_18.cypher;18;x;63;0;142
.\measurementA\cypher\run2\2_19.cypher;19;x;63;4;146
.\measurementA\cypher\run2\2_20.cypher;20;x;63;1;147
.\measurementA\cypher\run2\2_21.cypher;21;x;63;0;147
.\measurementA\cypher\run2\2_22.cypher;22;x;63;0;147
.\measurementA\cypher\run2\2_23.cypher;23;x;63;4;151
.\measurementA\cypher\run2\2_24.cypher;24;x;63;2;153
.\measurementA\cypher\run2\2_25.cypher;25;x;63;4;157
.\measurementA\cypher\run2\2_26.cypher;26;x;63;2;159
.\measurementA\cypher\run2\2_27.cypher;27;x;62;4;163
.\measurementA\cypher\run2\2_28.cypher;28;x;62;0;163
.\measurementA\cypher\run2\2_29.cypher;29;x;57;1;164
.\measurementA\cypher\run2\2_30.cypher;30;x;59;0;164
.\measurementA\cypher\run2\2_31.cypher;31;x;59;0;164
.\measurementA\cypher\run2\2_32.cypher;32;x;59;0;164
.\measurementA\cypher\run2\2_33.cypher;33;x;58;1;165
.\measurementA\cypher\run2\2_34.cypher;34;x;60;0;165
.\measurementA\cypher\run2\2_35.cypher;35;x;60;0;165
.\measurementA\cypher\run2\2_36.cypher;36;x;60;0;165
.\measurementA\cypher\run2\2_37.cypher;37;x;58;2;167
.\measurementA\cypher\run2\2_38.cypher;38;x;60;1;168
.\measurementA\cypher\run2\2_39.cypher;39;x;60;0;168
.\measurementA\cypher\run2\2_40.cypher;40;x;60;2;170
.\measurementA\cypher\run2\2_41.cypher;41;x;58;1;171
.\measurementA\cypher\run2\2_42.cypher;42;x;60;0;171
.\measurementA\cypher\run2\2_43.cypher;43;x;60;0;171
.\measurementA\cypher\run2\2_44.cypher;44;x;60;0;171
.\measurementA\cypher\run2\2_45.cypher;45;x;60;2;173
.\measurementA\cypher\run2\2_46.cypher;46;x;60;2;175
.\measurementA\cypher\run2\2_47.cypher;47;x;58;1;176
.\measurementA\cypher\run2\2_48.cypher;48;x;60;0;176
.\measurementA\cypher\run2\2_49.cypher;49;x;63;0;176
.\measurementA\cypher\run2\2_50.cypher;50;x;63;0;176
Model;Index;Size;InternalDiversity;NewShapes;AllCurrentShapes
.\measurementA\cypher\run3\3_1.cypher;1;x;58;58;58
.\measurementA\cypher\run3\3_2.cypher;2;x;58;0;58
.\measurementA\cypher\run3\3_3.cypher;3;x;59;11;69
.\measurementA\cypher\run3\3_4.cypher;4;x;59;0;69
.\measurementA\cypher\run3\3_5.cypher;5;x;58;6;75
.\measurementA\cypher\run3\3_6.cypher;6;x;58;0;75
.\measurementA\cypher\run3\3_7.cypher;7;x;59;5;80
.\measurementA\cypher\run3\3_8.cypher;8;x;59;0;80
.\measurementA\cypher\run3\3_9.cypher;9;x;63;17;97
.\measurementA\cypher\run3\3_10.cypher;10;x;63;12;109
.\measurementA\cypher\run3\3_11.cypher;11;x;63;13;122
.\measurementA\cypher\run3\3_12.cypher;12;x;63;0;122
.\measurementA\cypher\run3\3_13.cypher;13;x;63;0;122
.\measurementA\cypher\run3\3_14.cypher;14;x;63;0;122
.\measurementA\cypher\run3\3_15.cypher;15;x;67;10;132
.\measurementA\cypher\run3\3_16.cypher;16;x;67;5;137
.\measurementA\cypher\run3\3_17.cypher;17;x;67;6;143
.\measurementA\cypher\run3\3_18.cypher;18;x;67;7;150
.\measurementA\cypher\run3\3_19.cypher;19;x;66;4;154
.\measurementA\cypher\run3\3_20.cypher;20;x;66;2;156
.\measurementA\cypher\run3\3_21.cypher;21;x;66;2;158
.\measurementA\cypher\run3\3_22.cypher;22;x;69;21;179
.\measurementA\cypher\run3\3_23.cypher;23;x;69;4;183
.\measurementA\cypher\run3\3_24.cypher;24;x;71;3;186
.\measurementA\cypher\run3\3_25.cypher;25;x;67;6;192
.\measurementA\cypher\run3\3_26.cypher;26;x;65;1;193
.\measurementA\cypher\run3\3_27.cypher;27;x;64;7;200
.\measurementA\cypher\run3\3_28.cypher;28;x;64;0;200
.\measurementA\cypher\run3\3_29.cypher;29;x;64;4;204
.\measurementA\cypher\run3\3_30.cypher;30;x;64;0;204
.\measurementA\cypher\run3\3_31.cypher;31;x;64;4;208
.\measurementA\cypher\run3\3_32.cypher;32;x;64;0;208
.\measurementA\cypher\run3\3_33.cypher;33;x;64;4;212
.\measurementA\cypher\run3\3_34.cypher;34;x;64;2;214
.\measurementA\cypher\run3\3_35.cypher;35;x;63;4;218
.\measurementA\cypher\run3\3_36.cypher;36;x;63;2;220
.\measurementA\cypher\run3\3_37.cypher;37;x;67;0;220
.\measurementA\cypher\run3\3_38.cypher;38;x;67;1;221
.\measurementA\cypher\run3\3_39.cypher;39;x;67;0;221
.\measurementA\cypher\run3\3_40.cypher;40;x;67;0;221
.\measurementA\cypher\run3\3_41.cypher;41;x;67;0;221
.\measurementA\cypher\run3\3_42.cypher;42;x;67;0;221
.\measurementA\cypher\run3\3_43.cypher;43;x;67;1;222
.\measurementA\cypher\run3\3_44.cypher;44;x;67;0;222
.\measurementA\cypher\run3\3_45.cypher;45;x;67;0;222
.\measurementA\cypher\run3\3_46.cypher;46;x;71;3;225
.\measurementA\cypher\run3\3_47.cypher;47;x;71;0;225
.\measurementA\cypher\run3\3_48.cypher;48;x;64;0;225
.\measurementA\cypher\run3\3_49.cypher;49;x;68;1;226
.\measurementA\cypher\run3\3_50.cypher;50;x;64;0;226
Model;Index;Size;InternalDiversity;NewShapes;AllCurrentShapes
.\measurementA\cypher\run4\4_1.cypher;1;x;52;52;52
.\measurementA\cypher\run4\4_2.cypher;2;x;52;11;63
.\measurementA\cypher\run4\4_3.cypher;3;x;52;0;63
.\measurementA\cypher\run4\4_4.cypher;4;x;52;0;63
.\measurementA\cypher\run4\4_5.cypher;5;x;52;0;63
.\measurementA\cypher\run4\4_6.cypher;6;x;54;16;79
.\measurementA\cypher\run4\4_7.cypher;7;x;53;3;82
.\measurementA\cypher\run4\4_8.cypher;8;x;54;0;82
.\measurementA\cypher\run4\4_9.cypher;9;x;52;0;82
.\measurementA\cypher\run4\4_10.cypher;10;x;52;0;82
.\measurementA\cypher\run4\4_11.cypher;11;x;52;0;82
.\measurementA\cypher\run4\4_12.cypher;12;x;52;8;90
.\measurementA\cypher\run4\4_13.cypher;13;x;51;5;95
.\measurementA\cypher\run4\4_14.cypher;14;x;54;6;101
.\measurementA\cypher\run4\4_15.cypher;15;x;53;1;102
.\measurementA\cypher\run4\4_16.cypher;16;x;54;0;102
.\measurementA\cypher\run4\4_17.cypher;17;x;52;0;102
.\measurementA\cypher\run4\4_18.cypher;18;x;53;0;102
.\measurementA\cypher\run4\4_19.cypher;19;x;53;0;102
.\measurementA\cypher\run4\4_20.cypher;20;x;54;0;102
.\measurementA\cypher\run4\4_21.cypher;21;x;52;0;102
.\measurementA\cypher\run4\4_22.cypher;22;x;51;0;102
.\measurementA\cypher\run4\4_23.cypher;23;x;53;0;102
.\measurementA\cypher\run4\4_24.cypher;24;x;55;7;109
.\measurementA\cypher\run4\4_25.cypher;25;x;53;8;117
.\measurementA\cypher\run4\4_26.cypher;26;x;52;0;117
.\measurementA\cypher\run4\4_27.cypher;27;x;53;0;117
.\measurementA\cypher\run4\4_28.cypher;28;x;54;0;117
.\measurementA\cypher\run4\4_29.cypher;29;x;52;1;118
.\measurementA\cypher\run4\4_30.cypher;30;x;53;0;118
.\measurementA\cypher\run4\4_31.cypher;31;x;54;0;118
.\measurementA\cypher\run4\4_32.cypher;32;x;52;0;118
.\measurementA\cypher\run4\4_33.cypher;33;x;52;0;118
.\measurementA\cypher\run4\4_34.cypher;34;x;51;0;118
.\measurementA\cypher\run4\4_35.cypher;35;x;52;0;118
.\measurementA\cypher\run4\4_36.cypher;36;x;54;0;118
.\measurementA\cypher\run4\4_37.cypher;37;x;55;0;118
.\measurementA\cypher\run4\4_38.cypher;38;x;52;0;118
.\measurementA\cypher\run4\4_39.cypher;39;x;53;7;125
.\measurementA\cypher\run4\4_40.cypher;40;x;53;0;125
.\measurementA\cypher\run4\4_41.cypher;41;x;55;4;129
.\measurementA\cypher\run4\4_42.cypher;42;x;54;0;129
.\measurementA\cypher\run4\4_43.cypher;43;x;52;0;129
.\measurementA\cypher\run4\4_44.cypher;44;x;53;0;129
.\measurementA\cypher\run4\4_45.cypher;45;x;55;0;129
.\measurementA\cypher\run4\4_46.cypher;46;x;53;0;129
.\measurementA\cypher\run4\4_47.cypher;47;x;55;0;129
.\measurementA\cypher\run4\4_48.cypher;48;x;55;0;129
.\measurementA\cypher\run4\4_49.cypher;49;x;54;0;129
.\measurementA\cypher\run4\4_50.cypher;50;x;54;0;129
Model;Index;Size;InternalDiversity;NewShapes;AllCurrentShapes
.\measurementA\cypher\run5\5_1.cypher;1;x;52;52;52
.\measurementA\cypher\run5\5_2.cypher;2;x;53;14;66
.\measurementA\cypher\run5\5_3.cypher;3;x;53;10;76
.\measurementA\cypher\run5\5_4.cypher;4;x;52;0;76
.\measurementA\cypher\run5\5_5.cypher;5;x;52;0;76
.\measurementA\cypher\run5\5_6.cypher;6;x;53;0;76
.\measurementA\cypher\run5\5_7.cypher;7;x;53;0;76
.\measurementA\cypher\run5\5_8.cypher;8;x;55;6;82
.\measurementA\cypher\run5\5_9.cypher;9;x;53;0;82
.\measurementA\cypher\run5\5_10.cypher;10;x;53;0;82
.\measurementA\cypher\run5\5_11.cypher;11;x;55;0;82
.\measurementA\cypher\run5\5_12.cypher;12;x;55;0;82
.\measurementA\cypher\run5\5_13.cypher;13;x;56;21;103
.\measurementA\cypher\run5\5_14.cypher;14;x;58;2;105
.\measurementA\cypher\run5\5_15.cypher;15;x;53;7;112
.\measurementA\cypher\run5\5_16.cypher;16;x;54;2;114
.\measurementA\cypher\run5\5_17.cypher;17;x;54;0;114
.\measurementA\cypher\run5\5_18.cypher;18;x;53;5;119
.\measurementA\cypher\run5\5_19.cypher;19;x;54;0;119
.\measurementA\cypher\run5\5_20.cypher;20;x;53;0;119
.\measurementA\cypher\run5\5_21.cypher;21;x;54;4;123
.\measurementA\cypher\run5\5_22.cypher;22;x;53;0;123
.\measurementA\cypher\run5\5_23.cypher;23;x;54;0;123
.\measurementA\cypher\run5\5_24.cypher;24;x;53;0;123
.\measurementA\cypher\run5\5_25.cypher;25;x;53;0;123
.\measurementA\cypher\run5\5_26.cypher;26;x;56;2;125
.\measurementA\cypher\run5\5_27.cypher;27;x;56;0;125
.\measurementA\cypher\run5\5_28.cypher;28;x;54;1;126
.\measurementA\cypher\run5\5_29.cypher;29;x;54;0;126
.\measurementA\cypher\run5\5_30.cypher;30;x;56;0;126
.\measurementA\cypher\run5\5_31.cypher;31;x;54;0;126
.\measurementA\cypher\run5\5_32.cypher;32;x;54;0;126
.\measurementA\cypher\run5\5_33.cypher;33;x;54;0;126
.\measurementA\cypher\run5\5_34.cypher;34;x;56;0;126
.\measurementA\cypher\run5\5_35.cypher;35;x;56;0;126
.\measurementA\cypher\run5\5_36.cypher;36;x;54;0;126
.\measurementA\cypher\run5\5_37.cypher;37;x;54;0;126
.\measurementA\cypher\run5\5_38.cypher;38;x;56;0;126
.\measurementA\cypher\run5\5_39.cypher;39;x;57;0;126
.\measurementA\cypher\run5\5_40.cypher;40;x;57;0;126
.\measurementA\cypher\run5\5_41.cypher;41;x;57;0;126
.\measurementA\cypher\run5\5_42.cypher;42;x;59;1;127
.\measurementA\cypher\run5\5_43.cypher;43;x;59;0;127
.\measurementA\cypher\run5\5_44.cypher;44;x;59;0;127
.\measurementA\cypher\run5\5_45.cypher;45;x;59;0;127
.\measurementA\cypher\run5\5_46.cypher;46;x;59;0;127
.\measurementA\cypher\run5\5_47.cypher;47;x;59;0;127
.\measurementA\cypher\run5\5_48.cypher;48;x;59;5;132
.\measurementA\cypher\run5\5_49.cypher;49;x;59;0;132
.\measurementA\cypher\run5\5_50.cypher;50;x;59;0;132
Model;Index;Size;InternalDiversity;NewShapes;AllCurrentShapes
.\measurementA\cypher\run6\6_1.cypher;1;x;59;59;59
.\measurementA\cypher\run6\6_2.cypher;2;x;58;6;65
.\measurementA\cypher\run6\6_3.cypher;3;x;59;8;73
.\measurementA\cypher\run6\6_4.cypher;4;x;62;20;93
.\measurementA\cypher\run6\6_5.cypher;5;x;62;10;103
.\measurementA\cypher\run6\6_6.cypher;6;x;62;10;113
.\measurementA\cypher\run6\6_7.cypher;7;x;59;7;120
.\measurementA\cypher\run6\6_8.cypher;8;x;60;0;120
.\measurementA\cypher\run6\6_9.cypher;9;x;60;0;120
.\measurementA\cypher\run6\6_10.cypher;10;x;60;1;121
.\measurementA\cypher\run6\6_11.cypher;11;x;59;4;125
.\measurementA\cypher\run6\6_12.cypher;12;x;60;1;126
.\measurementA\cypher\run6\6_13.cypher;13;x;60;0;126
.\measurementA\cypher\run6\6_14.cypher;14;x;60;2;128
.\measurementA\cypher\run6\6_15.cypher;15;x;58;4;132
.\measurementA\cypher\run6\6_16.cypher;16;x;59;0;132
.\measurementA\cypher\run6\6_17.cypher;17;x;59;0;132
.\measurementA\cypher\run6\6_18.cypher;18;x;59;0;132
.\measurementA\cypher\run6\6_19.cypher;19;x;60;4;136
.\measurementA\cypher\run6\6_20.cypher;20;x;60;2;138
.\measurementA\cypher\run6\6_21.cypher;21;x;60;4;142
.\measurementA\cypher\run6\6_22.cypher;22;x;60;0;142
.\measurementA\cypher\run6\6_23.cypher;23;x;59;2;144
.\measurementA\cypher\run6\6_24.cypher;24;x;60;0;144
.\measurementA\cypher\run6\6_25.cypher;25;x;59;0;144
.\measurementA\cypher\run6\6_26.cypher;26;x;60;0;144
.\measurementA\cypher\run6\6_27.cypher;27;x;64;6;150
.\measurementA\cypher\run6\6_28.cypher;28;x;64;6;156
.\measurementA\cypher\run6\6_29.cypher;29;x;64;6;162
.\measurementA\cypher\run6\6_30.cypher;30;x;68;10;172
.\measurementA\cypher\run6\6_31.cypher;31;x;68;0;172
.\measurementA\cypher\run6\6_32.cypher;32;x;68;9;181
.\measurementA\cypher\run6\6_33.cypher;33;x;68;9;190
.\measurementA\cypher\run6\6_34.cypher;34;x;63;4;194
.\measurementA\cypher\run6\6_35.cypher;35;x;63;2;196
.\measurementA\cypher\run6\6_36.cypher;36;x;63;3;199
.\measurementA\cypher\run6\6_37.cypher;37;x;63;0;199
.\measurementA\cypher\run6\6_38.cypher;38;x;63;2;201
.\measurementA\cypher\run6\6_39.cypher;39;x;63;0;201
.\measurementA\cypher\run6\6_40.cypher;40;x;63;5;206
.\measurementA\cypher\run6\6_41.cypher;41;x;63;5;211
.\measurementA\cypher\run6\6_42.cypher;42;x;63;1;212
.\measurementA\cypher\run6\6_43.cypher;43;x;61;3;215
.\measurementA\cypher\run6\6_44.cypher;44;x;61;0;215
.\measurementA\cypher\run6\6_45.cypher;45;x;61;0;215
.\measurementA\cypher\run6\6_46.cypher;46;x;61;0;215
.\measurementA\cypher\run6\6_47.cypher;47;x;60;4;219
.\measurementA\cypher\run6\6_48.cypher;48;x;60;0;219
.\measurementA\cypher\run6\6_49.cypher;49;x;60;0;219
.\measurementA\cypher\run6\6_50.cypher;50;x;60;0;219
Model;Index;Size;InternalDiversity;NewShapes;AllCurrentShapes
.\measurementA\cypher\run7\7_1.cypher;1;x;60;60;60
.\measurementA\cypher\run7\7_2.cypher;2;x;58;13;73
.\measurementA\cypher\run7\7_3.cypher;3;x;59;0;73
.\measurementA\cypher\run7\7_4.cypher;4;x;59;0;73
.\measurementA\cypher\run7\7_5.cypher;5;x;59;8;81
.\measurementA\cypher\run7\7_6.cypher;6;x;59;0;81
.\measurementA\cypher\run7\7_7.cypher;7;x;58;6;87
.\measurementA\cypher\run7\7_8.cypher;8;x;60;0;87
.\measurementA\cypher\run7\7_9.cypher;9;x;59;0;87
.\measurementA\cypher\run7\7_10.cypher;10;x;60;0;87
.\measurementA\cypher\run7\7_11.cypher;11;x;58;0;87
.\measurementA\cypher\run7\7_12.cypher;12;x;59;3;90
.\measurementA\cypher\run7\7_13.cypher;13;x;61;14;104
.\measurementA\cypher\run7\7_14.cypher;14;x;62;5;109
.\measurementA\cypher\run7\7_15.cypher;15;x;62;0;109
.\measurementA\cypher\run7\7_16.cypher;16;x;62;9;118
.\measurementA\cypher\run7\7_17.cypher;17;x;62;0;118
.\measurementA\cypher\run7\7_18.cypher;18;x;62;10;128
.\measurementA\cypher\run7\7_19.cypher;19;x;63;4;132
.\measurementA\cypher\run7\7_20.cypher;20;x;63;0;132
.\measurementA\cypher\run7\7_21.cypher;21;x;63;0;132
.\measurementA\cypher\run7\7_22.cypher;22;x;63;0;132
.\measurementA\cypher\run7\7_23.cypher;23;x;60;7;139
.\measurementA\cypher\run7\7_24.cypher;24;x;60;3;142
.\measurementA\cypher\run7\7_25.cypher;25;x;59;4;146
.\measurementA\cypher\run7\7_26.cypher;26;x;60;0;146
.\measurementA\cypher\run7\7_27.cypher;27;x;60;0;146
.\measurementA\cypher\run7\7_28.cypher;28;x;60;0;146
.\measurementA\cypher\run7\7_29.cypher;29;x;59;2;148
.\measurementA\cypher\run7\7_30.cypher;30;x;60;0;148
.\measurementA\cypher\run7\7_31.cypher;31;x;59;4;152
.\measurementA\cypher\run7\7_32.cypher;32;x;60;1;153
.\measurementA\cypher\run7\7_33.cypher;33;x;60;0;153
.\measurementA\cypher\run7\7_34.cypher;34;x;60;2;155
.\measurementA\cypher\run7\7_35.cypher;35;x;58;4;159
.\measurementA\cypher\run7\7_36.cypher;36;x;59;0;159
.\measurementA\cypher\run7\7_37.cypher;37;x;59;0;159
.\measurementA\cypher\run7\7_38.cypher;38;x;59;0;159
.\measurementA\cypher\run7\7_39.cypher;39;x;59;4;163
.\measurementA\cypher\run7\7_40.cypher;40;x;60;0;163
.\measurementA\cypher\run7\7_41.cypher;41;x;60;0;163
.\measurementA\cypher\run7\7_42.cypher;42;x;60;0;163
.\measurementA\cypher\run7\7_43.cypher;43;x;63;5;168
.\measurementA\cypher\run7\7_44.cypher;44;x;63;1;169
.\measurementA\cypher\run7\7_45.cypher;45;x;63;0;169
.\measurementA\cypher\run7\7_46.cypher;46;x;63;0;169
.\measurementA\cypher\run7\7_47.cypher;47;x;66;9;178
.\measurementA\cypher\run7\7_48.cypher;48;x;66;1;179
.\measurementA\cypher\run7\7_49.cypher;49;x;66;6;185
.\measurementA\cypher\run7\7_50.cypher;50;x;69;21;206
Model;Index;Size;InternalDiversity;NewShapes;AllCurrentShapes
.\measurementA\cypher\run8\8_1.cypher;1;x;53;53;53
.\measurementA\cypher\run8\8_2.cypher;2;x;55;9;62
.\measurementA\cypher\run8\8_3.cypher;3;x;52;5;67
.\measurementA\cypher\run8\8_4.cypher;4;x;53;0;67
.\measurementA\cypher\run8\8_5.cypher;5;x;52;0;67
.\measurementA\cypher\run8\8_6.cypher;6;x;53;0;67
.\measurementA\cypher\run8\8_7.cypher;7;x;53;3;70
.\measurementA\cypher\run8\8_8.cypher;8;x;55;0;70
.\measurementA\cypher\run8\8_9.cypher;9;x;55;0;70
.\measurementA\cypher\run8\8_10.cypher;10;x;52;0;70
.\measurementA\cypher\run8\8_11.cypher;11;x;53;8;78
.\measurementA\cypher\run8\8_12.cypher;12;x;53;0;78
.\measurementA\cypher\run8\8_13.cypher;13;x;53;0;78
.\measurementA\cypher\run8\8_14.cypher;14;x;53;0;78
.\measurementA\cypher\run8\8_15.cypher;15;x;55;6;84
.\measurementA\cypher\run8\8_16.cypher;16;x;53;0;84
.\measurementA\cypher\run8\8_17.cypher;17;x;55;0;84
.\measurementA\cypher\run8\8_18.cypher;18;x;55;0;84
.\measurementA\cypher\run8\8_19.cypher;19;x;55;19;103
.\measurementA\cypher\run8\8_20.cypher;20;x;56;2;105
.\measurementA\cypher\run8\8_21.cypher;21;x;58;1;106
.\measurementA\cypher\run8\8_22.cypher;22;x;55;0;106
.\measurementA\cypher\run8\8_23.cypher;23;x;56;3;109
.\measurementA\cypher\run8\8_24.cypher;24;x;55;0;109
.\measurementA\cypher\run8\8_25.cypher;25;x;56;0;109
.\measurementA\cypher\run8\8_26.cypher;26;x;56;0;109
.\measurementA\cypher\run8\8_27.cypher;27;x;58;0;109
.\measurementA\cypher\run8\8_28.cypher;28;x;58;0;109
.\measurementA\cypher\run8\8_29.cypher;29;x;56;0;109
.\measurementA\cypher\run8\8_30.cypher;30;x;56;0;109
.\measurementA\cypher\run8\8_31.cypher;31;x;62;21;130
.\measurementA\cypher\run8\8_32.cypher;32;x;62;9;139
.\measurementA\cypher\run8\8_33.cypher;33;x;62;10;149
.\measurementA\cypher\run8\8_34.cypher;34;x;55;5;154
.\measurementA\cypher\run8\8_35.cypher;35;x;56;1;155
.\measurementA\cypher\run8\8_36.cypher;36;x;58;0;155
.\measurementA\cypher\run8\8_37.cypher;37;x;56;0;155
.\measurementA\cypher\run8\8_38.cypher;38;x;60;2;157
.\measurementA\cypher\run8\8_39.cypher;39;x;62;0;157
.\measurementA\cypher\run8\8_40.cypher;40;x;62;0;157
.\measurementA\cypher\run8\8_41.cypher;41;x;60;0;157
.\measurementA\cypher\run8\8_42.cypher;42;x;62;0;157
.\measurementA\cypher\run8\8_43.cypher;43;x;62;0;157
.\measurementA\cypher\run8\8_44.cypher;44;x;62;7;164
.\measurementA\cypher\run8\8_45.cypher;45;x;61;3;167
.\measurementA\cypher\run8\8_46.cypher;46;x;56;7;174
.\measurementA\cypher\run8\8_47.cypher;47;x;56;0;174
.\measurementA\cypher\run8\8_48.cypher;48;x;54;1;175
.\measurementA\cypher\run8\8_49.cypher;49;x;54;0;175
.\measurementA\cypher\run8\8_50.cypher;50;x;56;0;175
Model;Index;Size;InternalDiversity;NewShapes;AllCurrentShapes
.\measurementA\cypher\run9\9_1.cypher;1;x;52;52;52
.\measurementA\cypher\run9\9_2.cypher;2;x;52;8;60
.\measurementA\cypher\run9\9_3.cypher;3;x;52;0;60
.\measurementA\cypher\run9\9_4.cypher;4;x;52;0;60
.\measurementA\cypher\run9\9_5.cypher;5;x;52;0;60
.\measurementA\cypher\run9\9_6.cypher;6;x;52;0;60
.\measurementA\cypher\run9\9_7.cypher;7;x;53;5;65
.\measurementA\cypher\run9\9_8.cypher;8;x;52;9;74
.\measurementA\cypher\run9\9_9.cypher;9;x;52;0;74
.\measurementA\cypher\run9\9_10.cypher;10;x;52;0;74
.\measurementA\cypher\run9\9_11.cypher;11;x;54;7;81
.\measurementA\cypher\run9\9_12.cypher;12;x;54;0;81
.\measurementA\cypher\run9\9_13.cypher;13;x;54;0;81
.\measurementA\cypher\run9\9_14.cypher;14;x;51;0;81
.\measurementA\cypher\run9\9_15.cypher;15;x;54;4;85
.\measurementA\cypher\run9\9_16.cypher;16;x;54;0;85
.\measurementA\cypher\run9\9_17.cypher;17;x;52;3;88
.\measurementA\cypher\run9\9_18.cypher;18;x;52;0;88
.\measurementA\cypher\run9\9_19.cypher;19;x;52;0;88
.\measurementA\cypher\run9\9_20.cypher;20;x;53;0;88
.\measurementA\cypher\run9\9_21.cypher;21;x;52;0;88
.\measurementA\cypher\run9\9_22.cypher;22;x;53;0;88
.\measurementA\cypher\run9\9_23.cypher;23;x;52;0;88
.\measurementA\cypher\run9\9_24.cypher;24;x;53;0;88
.\measurementA\cypher\run9\9_25.cypher;25;x;54;0;88
.\measurementA\cypher\run9\9_26.cypher;26;x;54;0;88
.\measurementA\cypher\run9\9_27.cypher;27;x;54;0;88
.\measurementA\cypher\run9\9_28.cypher;28;x;54;13;101
.\measurementA\cypher\run9\9_29.cypher;29;x;51;0;101
.\measurementA\cypher\run9\9_30.cypher;30;x;52;0;101
.\measurementA\cypher\run9\9_31.cypher;31;x;54;0;101
.\measurementA\cypher\run9\9_32.cypher;32;x;52;0;101
.\measurementA\cypher\run9\9_33.cypher;33;x;55;2;103
.\measurementA\cypher\run9\9_34.cypher;34;x;53;0;103
.\measurementA\cypher\run9\9_35.cypher;35;x;53;1;104
.\measurementA\cypher\run9\9_36.cypher;36;x;55;6;110
.\measurementA\cypher\run9\9_37.cypher;37;x;55;0;110
.\measurementA\cypher\run9\9_38.cypher;38;x;53;0;110
.\measurementA\cypher\run9\9_39.cypher;39;x;53;0;110
.\measurementA\cypher\run9\9_40.cypher;40;x;53;0;110
.\measurementA\cypher\run9\9_41.cypher;41;x;55;0;110
.\measurementA\cypher\run9\9_42.cypher;42;x;55;0;110
.\measurementA\cypher\run9\9_43.cypher;43;x;55;0;110
.\measurementA\cypher\run9\9_44.cypher;44;x;52;0;110
.\measurementA\cypher\run9\9_45.cypher;45;x;53;0;110
.\measurementA\cypher\run9\9_46.cypher;46;x;52;0;110
.\measurementA\cypher\run9\9_47.cypher;47;x;55;0;110
.\measurementA\cypher\run9\9_48.cypher;48;x;51;0;110
.\measurementA\cypher\run9\9_49.cypher;49;x;52;0;110
.\measurementA\cypher\run9\9_50.cypher;50;x;52;0;110
Model;Index;Size;InternalDiversity;NewShapes;AllCurrentShapes
.\measurementAp\cypher\run1\1_1.cypher;1;x;61;61;61
.\measurementAp\cypher\run1\1_2.cypher;2;x;63;8;69
.\measurementAp\cypher\run1\1_3.cypher;3;x;63;12;81
.\measurementAp\cypher\run1\1_4.cypher;4;x;63;13;94
.\measurementAp\cypher\run1\1_5.cypher;5;x;67;15;109
.\measurementAp\cypher\run1\1_6.cypher;6;x;71;16;125
.\measurementAp\cypher\run1\1_7.cypher;7;x;69;10;135
.\measurementAp\cypher\run1\1_8.cypher;8;x;71;9;144
.\measurementAp\cypher\run1\1_9.cypher;9;x;73;22;166
.\measurementAp\cypher\run1\1_10.cypher;10;x;74;3;169
.\measurementAp\cypher\run1\1_11.cypher;11;x;74;6;175
.\measurementAp\cypher\run1\1_12.cypher;12;x;74;8;183
.\measurementAp\cypher\run1\1_13.cypher;13;x;71;2;185
.\measurementAp\cypher\run1\1_14.cypher;14;x;75;7;192
.\measurementAp\cypher\run1\1_15.cypher;15;x;75;0;192
.\measurementAp\cypher\run1\1_16.cypher;16;x;75;1;193
.\measurementAp\cypher\run1\1_17.cypher;17;x;75;9;202
.\measurementAp\cypher\run1\1_18.cypher;18;x;74;4;206
.\measurementAp\cypher\run1\1_19.cypher;19;x;74;2;208
.\measurementAp\cypher\run1\1_20.cypher;20;x;74;0;208
.\measurementAp\cypher\run1\1_21.cypher;21;x;74;2;210
.\measurementAp\cypher\run1\1_22.cypher;22;x;75;4;214
.\measurementAp\cypher\run1\1_23.cypher;23;x;75;1;215
.\measurementAp\cypher\run1\1_24.cypher;24;x;75;0;215
.\measurementAp\cypher\run1\1_25.cypher;25;x;75;0;215
.\measurementAp\cypher\run1\1_26.cypher;26;x;75;4;219
.\measurementAp\cypher\run1\1_27.cypher;27;x;75;0;219
.\measurementAp\cypher\run1\1_28.cypher;28;x;75;0;219
.\measurementAp\cypher\run1\1_29.cypher;29;x;75;0;219
.\measurementAp\cypher\run1\1_30.cypher;30;x;75;4;223
.\measurementAp\cypher\run1\1_31.cypher;31;x;75;2;225
.\measurementAp\cypher\run1\1_32.cypher;32;x;75;0;225
.\measurementAp\cypher\run1\1_33.cypher;33;x;75;2;227
.\measurementAp\cypher\run1\1_34.cypher;34;x;78;19;246
.\measurementAp\cypher\run1\1_35.cypher;35;x;78;3;249
.\measurementAp\cypher\run1\1_36.cypher;36;x;69;6;255
.\measurementAp\cypher\run1\1_37.cypher;37;x;71;2;257
.\measurementAp\cypher\run1\1_38.cypher;38;x;71;1;258
.\measurementAp\cypher\run1\1_39.cypher;39;x;78;2;260
.\measurementAp\cypher\run1\1_40.cypher;40;x;77;1;261
.\measurementAp\cypher\run1\1_41.cypher;41;x;74;0;261
.\measurementAp\cypher\run1\1_42.cypher;42;x;74;0;261
.\measurementAp\cypher\run1\1_43.cypher;43;x;75;0;261
.\measurementAp\cypher\run1\1_44.cypher;44;x;75;0;261
.\measurementAp\cypher\run1\1_45.cypher;45;x;74;2;263
.\measurementAp\cypher\run1\1_46.cypher;46;x;75;0;263
.\measurementAp\cypher\run1\1_47.cypher;47;x;74;0;263
.\measurementAp\cypher\run1\1_48.cypher;48;x;75;0;263
.\measurementAp\cypher\run1\1_49.cypher;49;x;74;0;263
.\measurementAp\cypher\run1\1_50.cypher;50;x;75;0;263
Model;Index;Size;InternalDiversity;NewShapes;AllCurrentShapes
.\measurementAp\cypher\run10\10_1.cypher;1;x;75;75;75
.\measurementAp\cypher\run10\10_2.cypher;2;x;73;15;90
.\measurementAp\cypher\run10\10_3.cypher;3;x;77;9;99
.\measurementAp\cypher\run10\10_4.cypher;4;x;75;6;105
.\measurementAp\cypher\run10\10_5.cypher;5;x;81;17;122
.\measurementAp\cypher\run10\10_6.cypher;6;x;79;16;138
.\measurementAp\cypher\run10\10_7.cypher;7;x;83;0;138
.\measurementAp\cypher\run10\10_8.cypher;8;x;79;7;145
.\measurementAp\cypher\run10\10_9.cypher;9;x;81;16;161
.\measurementAp\cypher\run10\10_10.cypher;10;x;83;6;167
.\measurementAp\cypher\run10\10_11.cypher;11;x;86;15;182
.\measurementAp\cypher\run10\10_12.cypher;12;x;86;12;194
.\measurementAp\cypher\run10\10_13.cypher;13;x;87;12;206
.\measurementAp\cypher\run10\10_14.cypher;14;x;91;9;215
.\measurementAp\cypher\run10\10_15.cypher;15;x;91;2;217
.\measurementAp\cypher\run10\10_16.cypher;16;x;91;8;225
.\measurementAp\cypher\run10\10_17.cypher;17;x;89;10;235
.\measurementAp\cypher\run10\10_18.cypher;18;x;89;7;242
.\measurementAp\cypher\run10\10_19.cypher;19;x;91;6;248
.\measurementAp\cypher\run10\10_20.cypher;20;x;90;4;252
.\measurementAp\cypher\run10\10_21.cypher;21;x;92;0;252
.\measurementAp\cypher\run10\10_22.cypher;22;x;90;4;256
.\measurementAp\cypher\run10\10_23.cypher;23;x;92;2;258
.\measurementAp\cypher\run10\10_24.cypher;24;x;90;4;262
.\measurementAp\cypher\run10\10_25.cypher;25;x;92;0;262
.\measurementAp\cypher\run10\10_26.cypher;26;x;89;4;266
.\measurementAp\cypher\run10\10_27.cypher;27;x;91;0;266
.\measurementAp\cypher\run10\10_28.cypher;28;x;90;4;270
.\measurementAp\cypher\run10\10_29.cypher;29;x;92;2;272
.\measurementAp\cypher\run10\10_30.cypher;30;x;90;4;276
.\measurementAp\cypher\run10\10_31.cypher;31;x;92;0;276
.\measurementAp\cypher\run10\10_32.cypher;32;x;91;7;283
.\measurementAp\cypher\run10\10_33.cypher;33;x;91;3;286
.\measurementAp\cypher\run10\10_34.cypher;34;x;89;2;288
.\measurementAp\cypher\run10\10_35.cypher;35;x;94;13;301
.\measurementAp\cypher\run10\10_36.cypher;36;x;92;1;302
.\measurementAp\cypher\run10\10_37.cypher;37;x;94;2;304
.\measurementAp\cypher\run10\10_38.cypher;38;x;92;6;310
.\measurementAp\cypher\run10\10_39.cypher;39;x;89;2;312
.\measurementAp\cypher\run10\10_40.cypher;40;x;94;4;316
.\measurementAp\cypher\run10\10_41.cypher;41;x;91;0;316
.\measurementAp\cypher\run10\10_42.cypher;42;x;85;4;320
.\measurementAp\cypher\run10\10_43.cypher;43;x;93;1;321
.\measurementAp\cypher\run10\10_44.cypher;44;x;93;0;321
.\measurementAp\cypher\run10\10_45.cypher;45;x;91;0;321
.\measurementAp\cypher\run10\10_46.cypher;46;x;92;0;321
.\measurementAp\cypher\run10\10_47.cypher;47;x;92;0;321
.\measurementAp\cypher\run10\10_48.cypher;48;x;92;0;321
.\measurementAp\cypher\run10\10_49.cypher;49;x;92;0;321
.\measurementAp\cypher\run10\10_50.cypher;50;x;92;0;321
Model;Index;Size;InternalDiversity;NewShapes;AllCurrentShapes
.\measurementAp\cypher\run2\2_1.cypher;1;x;61;61;61
.\measurementAp\cypher\run2\2_2.cypher;2;x;63;8;69
.\measurementAp\cypher\run2\2_3.cypher;3;x;63;9;78
.\measurementAp\cypher\run2\2_4.cypher;4;x;63;12;90
.\measurementAp\cypher\run2\2_5.cypher;5;x;63;0;90
.\measurementAp\cypher\run2\2_6.cypher;6;x;63;0;90
.\measurementAp\cypher\run2\2_7.cypher;7;x;66;12;102
.\measurementAp\cypher\run2\2_8.cypher;8;x;66;2;104
.\measurementAp\cypher\run2\2_9.cypher;9;x;66;6;110
.\measurementAp\cypher\run2\2_10.cypher;10;x;66;0;110
.\measurementAp\cypher\run2\2_11.cypher;11;x;66;0;110
.\measurementAp\cypher\run2\2_12.cypher;12;x;66;6;116
.\measurementAp\cypher\run2\2_13.cypher;13;x;71;26;142
.\measurementAp\cypher\run2\2_14.cypher;14;x;71;6;148
.\measurementAp\cypher\run2\2_15.cypher;15;x;71;11;159
.\measurementAp\cypher\run2\2_16.cypher;16;x;70;12;171
.\measurementAp\cypher\run2\2_17.cypher;17;x;70;0;171
.\measurementAp\cypher\run2\2_18.cypher;18;x;72;1;172
.\measurementAp\cypher\run2\2_19.cypher;19;x;72;4;176
.\measurementAp\cypher\run2\2_20.cypher;20;x;70;5;181
.\measurementAp\cypher\run2\2_21.cypher;21;x;72;2;183
.\measurementAp\cypher\run2\2_22.cypher;22;x;69;4;187
.\measurementAp\cypher\run2\2_23.cypher;23;x;69;2;189
.\measurementAp\cypher\run2\2_24.cypher;24;x;71;0;189
.\measurementAp\cypher\run2\2_25.cypher;25;x;71;2;191
.\measurementAp\cypher\run2\2_26.cypher;26;x;70;2;193
.\measurementAp\cypher\run2\2_27.cypher;27;x;72;0;193
.\measurementAp\cypher\run2\2_28.cypher;28;x;70;4;197
.\measurementAp\cypher\run2\2_29.cypher;29;x;70;0;197
.\measurementAp\cypher\run2\2_30.cypher;30;x;72;0;197
.\measurementAp\cypher\run2\2_31.cypher;31;x;72;0;197
.\measurementAp\cypher\run2\2_32.cypher;32;x;70;4;201
.\measurementAp\cypher\run2\2_33.cypher;33;x;72;1;202
.\measurementAp\cypher\run2\2_34.cypher;34;x;70;0;202
.\measurementAp\cypher\run2\2_35.cypher;35;x;72;0;202
.\measurementAp\cypher\run2\2_36.cypher;36;x;67;1;203
.\measurementAp\cypher\run2\2_37.cypher;37;x;67;2;205
.\measurementAp\cypher\run2\2_38.cypher;38;x;67;2;207
.\measurementAp\cypher\run2\2_39.cypher;39;x;67;1;208
.\measurementAp\cypher\run2\2_40.cypher;40;x;67;1;209
.\measurementAp\cypher\run2\2_41.cypher;41;x;67;0;209
.\measurementAp\cypher\run2\2_42.cypher;42;x;67;1;210
.\measurementAp\cypher\run2\2_43.cypher;43;x;73;15;225
.\measurementAp\cypher\run2\2_44.cypher;44;x;67;0;225
.\measurementAp\cypher\run2\2_45.cypher;45;x;74;1;226
.\measurementAp\cypher\run2\2_46.cypher;46;x;73;0;226
.\measurementAp\cypher\run2\2_47.cypher;47;x;74;8;234
.\measurementAp\cypher\run2\2_48.cypher;48;x;74;11;245
.\measurementAp\cypher\run2\2_49.cypher;49;x;74;0;245
.\measurementAp\cypher\run2\2_50.cypher;50;x;66;2;247
Model;Index;Size;InternalDiversity;NewShapes;AllCurrentShapes
.\measurementAp\cypher\run3\3_1.cypher;1;x;58;58;58
.\measurementAp\cypher\run3\3_2.cypher;2;x;58;0;58
.\measurementAp\cypher\run3\3_3.cypher;3;x;59;8;66
.\measurementAp\cypher\run3\3_4.cypher;4;x;59;0;66
.\measurementAp\cypher\run3\3_5.cypher;5;x;58;0;66
.\measurementAp\cypher\run3\3_6.cypher;6;x;58;0;66
.\measurementAp\cypher\run3\3_7.cypher;7;x;58;0;66
.\measurementAp\cypher\run3\3_8.cypher;8;x;59;0;66
.\measurementAp\cypher\run3\3_9.cypher;9;x;59;0;66
.\measurementAp\cypher\run3\3_10.cypher;10;x;59;0;66
.\measurementAp\cypher\run3\3_11.cypher;11;x;59;0;66
.\measurementAp\cypher\run3\3_12.cypher;12;x;58;0;66
.\measurementAp\cypher\run3\3_13.cypher;13;x;59;7;73
.\measurementAp\cypher\run3\3_14.cypher;14;x;60;0;73
.\measurementAp\cypher\run3\3_15.cypher;15;x;59;0;73
.\measurementAp\cypher\run3\3_16.cypher;16;x;60;0;73
.\measurementAp\cypher\run3\3_17.cypher;17;x;60;0;73
.\measurementAp\cypher\run3\3_18.cypher;18;x;60;0;73
.\measurementAp\cypher\run3\3_19.cypher;19;x;60;10;83
.\measurementAp\cypher\run3\3_20.cypher;20;x;60;0;83
.\measurementAp\cypher\run3\3_21.cypher;21;x;60;4;87
.\measurementAp\cypher\run3\3_22.cypher;22;x;60;0;87
.\measurementAp\cypher\run3\3_23.cypher;23;x;60;2;89
.\measurementAp\cypher\run3\3_24.cypher;24;x;60;0;89
.\measurementAp\cypher\run3\3_25.cypher;25;x;60;0;89
.\measurementAp\cypher\run3\3_26.cypher;26;x;60;4;93
.\measurementAp\cypher\run3\3_27.cypher;27;x;60;0;93
.\measurementAp\cypher\run3\3_28.cypher;28;x;59;4;97
.\measurementAp\cypher\run3\3_29.cypher;29;x;59;0;97
.\measurementAp\cypher\run3\3_30.cypher;30;x;59;0;97
.\measurementAp\cypher\run3\3_31.cypher;31;x;59;0;97
.\measurementAp\cypher\run3\3_32.cypher;32;x;59;0;97
.\measurementAp\cypher\run3\3_33.cypher;33;x;60;0;97
.\measurementAp\cypher\run3\3_34.cypher;34;x;60;0;97
.\measurementAp\cypher\run3\3_35.cypher;35;x;64;18;115
.\measurementAp\cypher\run3\3_36.cypher;36;x;64;13;128
.\measurementAp\cypher\run3\3_37.cypher;37;x;64;0;128
.\measurementAp\cypher\run3\3_38.cypher;38;x;64;0;128
.\measurementAp\cypher\run3\3_39.cypher;39;x;64;8;136
.\measurementAp\cypher\run3\3_40.cypher;40;x;64;0;136
.\measurementAp\cypher\run3\3_41.cypher;41;x;59;4;140
.\measurementAp\cypher\run3\3_42.cypher;42;x;60;2;142
.\measurementAp\cypher\run3\3_43.cypher;43;x;60;0;142
.\measurementAp\cypher\run3\3_44.cypher;44;x;60;0;142
.\measurementAp\cypher\run3\3_45.cypher;45;x;59;0;142
.\measurementAp\cypher\run3\3_46.cypher;46;x;60;2;144
.\measurementAp\cypher\run3\3_47.cypher;47;x;60;0;144
.\measurementAp\cypher\run3\3_48.cypher;48;x;64;2;146
.\measurementAp\cypher\run3\3_49.cypher;49;x;60;0;146
.\measurementAp\cypher\run3\3_50.cypher;50;x;64;0;146
Model;Index;Size;InternalDiversity;NewShapes;AllCurrentShapes
.\measurementAp\cypher\run4\4_1.cypher;1;x;59;59;59
.\measurementAp\cypher\run4\4_2.cypher;2;x;59;0;59
.\measurementAp\cypher\run4\4_3.cypher;3;x;60;7;66
.\measurementAp\cypher\run4\4_4.cypher;4;x;60;0;66
.\measurementAp\cypher\run4\4_5.cypher;5;x;59;10;76
.\measurementAp\cypher\run4\4_6.cypher;6;x;61;1;77
.\measurementAp\cypher\run4\4_7.cypher;7;x;60;0;77
.\measurementAp\cypher\run4\4_8.cypher;8;x;61;10;87
.\measurementAp\cypher\run4\4_9.cypher;9;x;59;5;92
.\measurementAp\cypher\run4\4_10.cypher;10;x;60;1;93
.\measurementAp\cypher\run4\4_11.cypher;11;x;61;0;93
.\measurementAp\cypher\run4\4_12.cypher;12;x;61;2;95
.\measurementAp\cypher\run4\4_13.cypher;13;x;59;4;99
.\measurementAp\cypher\run4\4_14.cypher;14;x;61;0;99
.\measurementAp\cypher\run4\4_15.cypher;15;x;60;0;99
.\measurementAp\cypher\run4\4_16.cypher;16;x;61;0;99
.\measurementAp\cypher\run4\4_17.cypher;17;x;58;4;103
.\measurementAp\cypher\run4\4_18.cypher;18;x;59;0;103
.\measurementAp\cypher\run4\4_19.cypher;19;x;60;0;103
.\measurementAp\cypher\run4\4_20.cypher;20;x;60;0;103
.\measurementAp\cypher\run4\4_21.cypher;21;x;61;4;107
.\measurementAp\cypher\run4\4_22.cypher;22;x;61;2;109
.\measurementAp\cypher\run4\4_23.cypher;23;x;59;2;111
.\measurementAp\cypher\run4\4_24.cypher;24;x;60;0;111
.\measurementAp\cypher\run4\4_25.cypher;25;x;62;12;123
.\measurementAp\cypher\run4\4_26.cypher;26;x;63;0;123
.\measurementAp\cypher\run4\4_27.cypher;27;x;63;5;128
.\measurementAp\cypher\run4\4_28.cypher;28;x;63;13;141
.\measurementAp\cypher\run4\4_29.cypher;29;x;63;1;142
.\measurementAp\cypher\run4\4_30.cypher;30;x;63;0;142
.\measurementAp\cypher\run4\4_31.cypher;31;x;63;0;142
.\measurementAp\cypher\run4\4_32.cypher;32;x;63;5;147
.\measurementAp\cypher\run4\4_33.cypher;33;x;63;0;147
.\measurementAp\cypher\run4\4_34.cypher;34;x;63;0;147
.\measurementAp\cypher\run4\4_35.cypher;35;x;63;8;155
.\measurementAp\cypher\run4\4_36.cypher;36;x;63;2;157
.\measurementAp\cypher\run4\4_37.cypher;37;x;63;2;159
.\measurementAp\cypher\run4\4_38.cypher;38;x;64;0;159
.\measurementAp\cypher\run4\4_39.cypher;39;x;64;1;160
.\measurementAp\cypher\run4\4_40.cypher;40;x;64;0;160
.\measurementAp\cypher\run4\4_41.cypher;41;x;64;0;160
.\measurementAp\cypher\run4\4_42.cypher;42;x;64;0;160
.\measurementAp\cypher\run4\4_43.cypher;43;x;64;0;160
.\measurementAp\cypher\run4\4_44.cypher;44;x;64;1;161
.\measurementAp\cypher\run4\4_45.cypher;45;x;64;0;161
.\measurementAp\cypher\run4\4_46.cypher;46;x;64;1;162
.\measurementAp\cypher\run4\4_47.cypher;47;x;64;0;162
.\measurementAp\cypher\run4\4_48.cypher;48;x;64;0;162
.\measurementAp\cypher\run4\4_49.cypher;49;x;64;0;162
.\measurementAp\cypher\run4\4_50.cypher;50;x;64;0;162
Model;Index;Size;InternalDiversity;NewShapes;AllCurrentShapes
.\measurementAp\cypher\run5\5_1.cypher;1;x;59;59;59
.\measurementAp\cypher\run5\5_2.cypher;2;x;63;13;72
.\measurementAp\cypher\run5\5_3.cypher;3;x;63;9;81
.\measurementAp\cypher\run5\5_4.cypher;4;x;63;12;93
.\measurementAp\cypher\run5\5_5.cypher;5;x;67;16;109
.\measurementAp\cypher\run5\5_6.cypher;6;x;67;1;110
.\measurementAp\cypher\run5\5_7.cypher;7;x;67;1;111
.\measurementAp\cypher\run5\5_8.cypher;8;x;67;5;116
.\measurementAp\cypher\run5\5_9.cypher;9;x;65;8;124
.\measurementAp\cypher\run5\5_10.cypher;10;x;66;7;131
.\measurementAp\cypher\run5\5_11.cypher;11;x;66;0;131
.\measurementAp\cypher\run5\5_12.cypher;12;x;66;0;131
.\measurementAp\cypher\run5\5_13.cypher;13;x;66;8;139
.\measurementAp\cypher\run5\5_14.cypher;14;x;66;4;143
.\measurementAp\cypher\run5\5_15.cypher;15;x;66;0;143
.\measurementAp\cypher\run5\5_16.cypher;16;x;66;0;143
.\measurementAp\cypher\run5\5_17.cypher;17;x;66;0;143
.\measurementAp\cypher\run5\5_18.cypher;18;x;66;4;147
.\measurementAp\cypher\run5\5_19.cypher;19;x;66;2;149
.\measurementAp\cypher\run5\5_20.cypher;20;x;66;0;149
.\measurementAp\cypher\run5\5_21.cypher;21;x;66;2;151
.\measurementAp\cypher\run5\5_22.cypher;22;x;66;4;155
.\measurementAp\cypher\run5\5_23.cypher;23;x;66;0;155
.\measurementAp\cypher\run5\5_24.cypher;24;x;65;4;159
.\measurementAp\cypher\run5\5_25.cypher;25;x;65;2;161
.\measurementAp\cypher\run5\5_26.cypher;26;x;66;0;161
.\measurementAp\cypher\run5\5_27.cypher;27;x;66;0;161
.\measurementAp\cypher\run5\5_28.cypher;28;x;65;2;163
.\measurementAp\cypher\run5\5_29.cypher;29;x;65;0;163
.\measurementAp\cypher\run5\5_30.cypher;30;x;71;14;177
.\measurementAp\cypher\run5\5_31.cypher;31;x;71;1;178
.\measurementAp\cypher\run5\5_32.cypher;32;x;71;7;185
.\measurementAp\cypher\run5\5_33.cypher;33;x;71;0;185
.\measurementAp\cypher\run5\5_34.cypher;34;x;71;2;187
.\measurementAp\cypher\run5\5_35.cypher;35;x;74;17;204
.\measurementAp\cypher\run5\5_36.cypher;36;x;74;11;215
.\measurementAp\cypher\run5\5_37.cypher;37;x;69;3;218
.\measurementAp\cypher\run5\5_38.cypher;38;x;71;1;219
.\measurementAp\cypher\run5\5_39.cypher;39;x;71;0;219
.\measurementAp\cypher\run5\5_40.cypher;40;x;71;0;219
.\measurementAp\cypher\run5\5_41.cypher;41;x;73;7;226
.\measurementAp\cypher\run5\5_42.cypher;42;x;74;2;228
.\measurementAp\cypher\run5\5_43.cypher;43;x;74;3;231
.\measurementAp\cypher\run5\5_44.cypher;44;x;77;7;238
.\measurementAp\cypher\run5\5_45.cypher;45;x;77;9;247
.\measurementAp\cypher\run5\5_46.cypher;46;x;77;2;249
.\measurementAp\cypher\run5\5_47.cypher;47;x;78;4;253
.\measurementAp\cypher\run5\5_48.cypher;48;x;78;2;255
.\measurementAp\cypher\run5\5_49.cypher;49;x;78;1;256
.\measurementAp\cypher\run5\5_50.cypher;50;x;78;0;256
Model;Index;Size;InternalDiversity;NewShapes;AllCurrentShapes
.\measurementAp\cypher\run6\6_1.cypher;1;x;63;63;63
.\measurementAp\cypher\run6\6_2.cypher;2;x;63;12;75
.\measurementAp\cypher\run6\6_3.cypher;3;x;63;13;88
.\measurementAp\cypher\run6\6_4.cypher;4;x;66;12;100
.\measurementAp\cypher\run6\6_5.cypher;5;x;66;7;107
.\measurementAp\cypher\run6\6_6.cypher;6;x;66;6;113
.\measurementAp\cypher\run6\6_7.cypher;7;x;69;21;134
.\measurementAp\cypher\run6\6_8.cypher;8;x;71;11;145
.\measurementAp\cypher\run6\6_9.cypher;9;x;71;4;149
.\measurementAp\cypher\run6\6_10.cypher;10;x;71;6;155
.\measurementAp\cypher\run6\6_11.cypher;11;x;71;3;158
.\measurementAp\cypher\run6\6_12.cypher;12;x;69;3;161
.\measurementAp\cypher\run6\6_13.cypher;13;x;71;2;163
.\measurementAp\cypher\run6\6_14.cypher;14;x;71;1;164
.\measurementAp\cypher\run6\6_15.cypher;15;x;74;10;174
.\measurementAp\cypher\run6\6_16.cypher;16;x;74;5;179
.\measurementAp\cypher\run6\6_17.cypher;17;x;74;8;187
.\measurementAp\cypher\run6\6_18.cypher;18;x;67;12;199
.\measurementAp\cypher\run6\6_19.cypher;19;x;67;0;199
.\measurementAp\cypher\run6\6_20.cypher;20;x;67;0;199
.\measurementAp\cypher\run6\6_21.cypher;21;x;67;0;199
.\measurementAp\cypher\run6\6_22.cypher;22;x;65;0;199
.\measurementAp\cypher\run6\6_23.cypher;23;x;65;0;199
.\measurementAp\cypher\run6\6_24.cypher;24;x;68;4;203
.\measurementAp\cypher\run6\6_25.cypher;25;x;68;0;203
.\measurementAp\cypher\run6\6_26.cypher;26;x;68;0;203
.\measurementAp\cypher\run6\6_27.cypher;27;x;68;0;203
.\measurementAp\cypher\run6\6_28.cypher;28;x;66;1;204
.\measurementAp\cypher\run6\6_29.cypher;29;x;66;0;204
.\measurementAp\cypher\run6\6_30.cypher;30;x;68;4;208
.\measurementAp\cypher\run6\6_31.cypher;31;x;68;2;210
.\measurementAp\cypher\run6\6_32.cypher;32;x;68;0;210
.\measurementAp\cypher\run6\6_33.cypher;33;x;66;2;212
.\measurementAp\cypher\run6\6_34.cypher;34;x;68;0;212
.\measurementAp\cypher\run6\6_35.cypher;35;x;66;2;214
.\measurementAp\cypher\run6\6_36.cypher;36;x;78;12;226
.\measurementAp\cypher\run6\6_37.cypher;37;x;78;10;236
.\measurementAp\cypher\run6\6_38.cypher;38;x;77;11;247
.\measurementAp\cypher\run6\6_39.cypher;39;x;68;4;251
.\measurementAp\cypher\run6\6_40.cypher;40;x;68;2;253
.\measurementAp\cypher\run6\6_41.cypher;41;x;68;0;253
.\measurementAp\cypher\run6\6_42.cypher;42;x;66;2;255
.\measurementAp\cypher\run6\6_43.cypher;43;x;68;0;255
.\measurementAp\cypher\run6\6_44.cypher;44;x;66;2;257
.\measurementAp\cypher\run6\6_45.cypher;45;x;68;4;261
.\measurementAp\cypher\run6\6_46.cypher;46;x;68;1;262
.\measurementAp\cypher\run6\6_47.cypher;47;x;68;0;262
.\measurementAp\cypher\run6\6_48.cypher;48;x;68;0;262
.\measurementAp\cypher\run6\6_49.cypher;49;x;66;0;262
.\measurementAp\cypher\run6\6_50.cypher;50;x;66;0;262
Model;Index;Size;InternalDiversity;NewShapes;AllCurrentShapes
.\measurementAp\cypher\run7\7_1.cypher;1;x;58;58;58
.\measurementAp\cypher\run7\7_2.cypher;2;x;58;0;58
.\measurementAp\cypher\run7\7_3.cypher;3;x;59;8;66
.\measurementAp\cypher\run7\7_4.cypher;4;x;58;0;66
.\measurementAp\cypher\run7\7_5.cypher;5;x;59;0;66
.\measurementAp\cypher\run7\7_6.cypher;6;x;59;0;66
.\measurementAp\cypher\run7\7_7.cypher;7;x;63;19;85
.\measurementAp\cypher\run7\7_8.cypher;8;x;63;13;98
.\measurementAp\cypher\run7\7_9.cypher;9;x;63;0;98
.\measurementAp\cypher\run7\7_10.cypher;10;x;63;0;98
.\measurementAp\cypher\run7\7_11.cypher;11;x;63;0;98
.\measurementAp\cypher\run7\7_12.cypher;12;x;63;0;98
.\measurementAp\cypher\run7\7_13.cypher;13;x;63;10;108
.\measurementAp\cypher\run7\7_14.cypher;14;x;63;0;108
.\measurementAp\cypher\run7\7_15.cypher;15;x;63;0;108
.\measurementAp\cypher\run7\7_16.cypher;16;x;66;15;123
.\measurementAp\cypher\run7\7_17.cypher;17;x;66;7;130
.\measurementAp\cypher\run7\7_18.cypher;18;x;66;6;136
.\measurementAp\cypher\run7\7_19.cypher;19;x;70;11;147
.\measurementAp\cypher\run7\7_20.cypher;20;x;68;12;159
.\measurementAp\cypher\run7\7_21.cypher;21;x;68;10;169
.\measurementAp\cypher\run7\7_22.cypher;22;x;66;4;173
.\measurementAp\cypher\run7\7_23.cypher;23;x;66;0;173
.\measurementAp\cypher\run7\7_24.cypher;24;x;66;1;174
.\measurementAp\cypher\run7\7_25.cypher;25;x;66;1;175
.\measurementAp\cypher\run7\7_26.cypher;26;x;64;7;182
.\measurementAp\cypher\run7\7_27.cypher;27;x;64;2;184
.\measurementAp\cypher\run7\7_28.cypher;28;x;64;2;186
.\measurementAp\cypher\run7\7_29.cypher;29;x;64;0;186
.\measurementAp\cypher\run7\7_30.cypher;30;x;64;2;188
.\measurementAp\cypher\run7\7_31.cypher;31;x;64;0;188
.\measurementAp\cypher\run7\7_32.cypher;32;x;69;6;194
.\measurementAp\cypher\run7\7_33.cypher;33;x;69;4;198
.\measurementAp\cypher\run7\7_34.cypher;34;x;64;4;202
.\measurementAp\cypher\run7\7_35.cypher;35;x;64;0;202
.\measurementAp\cypher\run7\7_36.cypher;36;x;64;0;202
.\measurementAp\cypher\run7\7_37.cypher;37;x;64;0;202
.\measurementAp\cypher\run7\7_38.cypher;38;x;64;4;206
.\measurementAp\cypher\run7\7_39.cypher;39;x;64;2;208
.\measurementAp\cypher\run7\7_40.cypher;40;x;64;0;208
.\measurementAp\cypher\run7\7_41.cypher;41;x;64;2;210
.\measurementAp\cypher\run7\7_42.cypher;42;x;64;0;210
.\measurementAp\cypher\run7\7_43.cypher;43;x;64;2;212
.\measurementAp\cypher\run7\7_44.cypher;44;x;64;4;216
.\measurementAp\cypher\run7\7_45.cypher;45;x;64;0;216
.\measurementAp\cypher\run7\7_46.cypher;46;x;63;4;220
.\measurementAp\cypher\run7\7_47.cypher;47;x;63;0;220
.\measurementAp\cypher\run7\7_48.cypher;48;x;63;0;220
.\measurementAp\cypher\run7\7_49.cypher;49;x;63;1;221
.\measurementAp\cypher\run7\7_50.cypher;50;x;63;0;221
Model;Index;Size;InternalDiversity;NewShapes;AllCurrentShapes
.\measurementAp\cypher\run8\8_1.cypher;1;x;63;63;63
.\measurementAp\cypher\run8\8_2.cypher;2;x;63;15;78
.\measurementAp\cypher\run8\8_3.cypher;3;x;63;9;87
.\measurementAp\cypher\run8\8_4.cypher;4;x;63;7;94
.\measurementAp\cypher\run8\8_5.cypher;5;x;63;0;94
.\measurementAp\cypher\run8\8_6.cypher;6;x;63;1;95
.\measurementAp\cypher\run8\8_7.cypher;7;x;63;0;95
.\measurementAp\cypher\run8\8_8.cypher;8;x;63;7;102
.\measurementAp\cypher\run8\8_9.cypher;9;x;63;0;102
.\measurementAp\cypher\run8\8_10.cypher;10;x;64;4;106
.\measurementAp\cypher\run8\8_11.cypher;11;x;64;0;106
.\measurementAp\cypher\run8\8_12.cypher;12;x;64;0;106
.\measurementAp\cypher\run8\8_13.cypher;13;x;64;0;106
.\measurementAp\cypher\run8\8_14.cypher;14;x;64;0;106
.\measurementAp\cypher\run8\8_15.cypher;15;x;64;0;106
.\measurementAp\cypher\run8\8_16.cypher;16;x;64;4;110
.\measurementAp\cypher\run8\8_17.cypher;17;x;64;0;110
.\measurementAp\cypher\run8\8_18.cypher;18;x;64;1;111
.\measurementAp\cypher\run8\8_19.cypher;19;x;64;0;111
.\measurementAp\cypher\run8\8_20.cypher;20;x;64;0;111
.\measurementAp\cypher\run8\8_21.cypher;21;x;64;0;111
.\measurementAp\cypher\run8\8_22.cypher;22;x;64;4;115
.\measurementAp\cypher\run8\8_23.cypher;23;x;64;2;117
.\measurementAp\cypher\run8\8_24.cypher;24;x;64;0;117
.\measurementAp\cypher\run8\8_25.cypher;25;x;64;2;119
.\measurementAp\cypher\run8\8_26.cypher;26;x;64;0;119
.\measurementAp\cypher\run8\8_27.cypher;27;x;64;2;121
.\measurementAp\cypher\run8\8_28.cypher;28;x;64;4;125
.\measurementAp\cypher\run8\8_29.cypher;29;x;64;2;127
.\measurementAp\cypher\run8\8_30.cypher;30;x;64;2;129
.\measurementAp\cypher\run8\8_31.cypher;31;x;64;0;129
.\measurementAp\cypher\run8\8_32.cypher;32;x;64;0;129
.\measurementAp\cypher\run8\8_33.cypher;33;x;64;2;131
.\measurementAp\cypher\run8\8_34.cypher;34;x;67;15;146
.\measurementAp\cypher\run8\8_35.cypher;35;x;71;15;161
.\measurementAp\cypher\run8\8_36.cypher;36;x;68;5;166
.\measurementAp\cypher\run8\8_37.cypher;37;x;68;0;166
.\measurementAp\cypher\run8\8_38.cypher;38;x;68;0;166
.\measurementAp\cypher\run8\8_39.cypher;39;x;68;0;166
.\measurementAp\cypher\run8\8_40.cypher;40;x;68;0;166
.\measurementAp\cypher\run8\8_41.cypher;41;x;68;6;172
.\measurementAp\cypher\run8\8_42.cypher;42;x;68;9;181
.\measurementAp\cypher\run8\8_43.cypher;43;x;68;0;181
.\measurementAp\cypher\run8\8_44.cypher;44;x;68;4;185
.\measurementAp\cypher\run8\8_45.cypher;45;x;68;4;189
.\measurementAp\cypher\run8\8_46.cypher;46;x;69;2;191
.\measurementAp\cypher\run8\8_47.cypher;47;x;69;0;191
.\measurementAp\cypher\run8\8_48.cypher;48;x;68;4;195
.\measurementAp\cypher\run8\8_49.cypher;49;x;68;0;195
.\measurementAp\cypher\run8\8_50.cypher;50;x;69;2;197
Model;Index;Size;InternalDiversity;NewShapes;AllCurrentShapes
.\measurementAp\cypher\run9\9_1.cypher;1;x;59;59;59
.\measurementAp\cypher\run9\9_2.cypher;2;x;63;13;72
.\measurementAp\cypher\run9\9_3.cypher;3;x;63;0;72
.\measurementAp\cypher\run9\9_4.cypher;4;x;63;12;84
.\measurementAp\cypher\run9\9_5.cypher;5;x;63;0;84
.\measurementAp\cypher\run9\9_6.cypher;6;x;59;0;84
.\measurementAp\cypher\run9\9_7.cypher;7;x;63;9;93
.\measurementAp\cypher\run9\9_8.cypher;8;x;63;0;93
.\measurementAp\cypher\run9\9_9.cypher;9;x;67;16;109
.\measurementAp\cypher\run9\9_10.cypher;10;x;67;5;114
.\measurementAp\cypher\run9\9_11.cypher;11;x;67;0;114
.\measurementAp\cypher\run9\9_12.cypher;12;x;67;0;114
.\measurementAp\cypher\run9\9_13.cypher;13;x;65;9;123
.\measurementAp\cypher\run9\9_14.cypher;14;x;65;0;123
.\measurementAp\cypher\run9\9_15.cypher;15;x;66;6;129
.\measurementAp\cypher\run9\9_16.cypher;16;x;66;3;132
.\measurementAp\cypher\run9\9_17.cypher;17;x;66;0;132
.\measurementAp\cypher\run9\9_18.cypher;18;x;66;2;134
.\measurementAp\cypher\run9\9_19.cypher;19;x;66;0;134
.\measurementAp\cypher\run9\9_20.cypher;20;x;66;0;134
.\measurementAp\cypher\run9\9_21.cypher;21;x;63;0;134
.\measurementAp\cypher\run9\9_22.cypher;22;x;63;0;134
.\measurementAp\cypher\run9\9_23.cypher;23;x;63;0;134
.\measurementAp\cypher\run9\9_24.cypher;24;x;63;0;134
.\measurementAp\cypher\run9\9_25.cypher;25;x;63;0;134
.\measurementAp\cypher\run9\9_26.cypher;26;x;63;0;134
.\measurementAp\cypher\run9\9_27.cypher;27;x;71;17;151
.\measurementAp\cypher\run9\9_28.cypher;28;x;71;9;160
.\measurementAp\cypher\run9\9_29.cypher;29;x;71;4;164
.\measurementAp\cypher\run9\9_30.cypher;30;x;69;3;167
.\measurementAp\cypher\run9\9_31.cypher;31;x;71;3;170
.\measurementAp\cypher\run9\9_32.cypher;32;x;67;2;172
.\measurementAp\cypher\run9\9_33.cypher;33;x;67;0;172
.\measurementAp\cypher\run9\9_34.cypher;34;x;71;3;175
.\measurementAp\cypher\run9\9_35.cypher;35;x;71;0;175
.\measurementAp\cypher\run9\9_36.cypher;36;x;67;0;175
.\measurementAp\cypher\run9\9_37.cypher;37;x;67;0;175
.\measurementAp\cypher\run9\9_38.cypher;38;x;67;0;175
.\measurementAp\cypher\run9\9_39.cypher;39;x;71;2;177
.\measurementAp\cypher\run9\9_40.cypher;40;x;67;0;177
.\measurementAp\cypher\run9\9_41.cypher;41;x;71;1;178
.\measurementAp\cypher\run9\9_42.cypher;42;x;71;0;178
.\measurementAp\cypher\run9\9_43.cypher;43;x;69;1;179
.\measurementAp\cypher\run9\9_44.cypher;44;x;69;0;179
.\measurementAp\cypher\run9\9_45.cypher;45;x;74;16;195
.\measurementAp\cypher\run9\9_46.cypher;46;x;71;5;200
.\measurementAp\cypher\run9\9_47.cypher;47;x;71;0;200
.\measurementAp\cypher\run9\9_48.cypher;48;x;72;7;207
.\measurementAp\cypher\run9\9_49.cypher;49;x;72;1;208
.\measurementAp\cypher\run9\9_50.cypher;50;x;71;4;212
Model;Index;Size;InternalDiversity;NewShapes;AllCurrentShapes
.\measurementApp\cypher\run1\1_1.cypher;1;x;72;72;72
.\measurementApp\cypher\run1\1_2.cypher;2;x;72;33;105
.\measurementApp\cypher\run1\1_3.cypher;3;x;75;16;121
.\measurementApp\cypher\run1\1_4.cypher;4;x;78;15;136
.\measurementApp\cypher\run1\1_5.cypher;5;x;78;8;144
.\measurementApp\cypher\run1\1_6.cypher;6;x;75;5;149
.\measurementApp\cypher\run1\1_7.cypher;7;x;75;2;151
.\measurementApp\cypher\run1\1_8.cypher;8;x;78;2;153
.\measurementApp\cypher\run1\1_9.cypher;9;x;74;4;157
.\measurementApp\cypher\run1\1_10.cypher;10;x;74;2;159
.\measurementApp\cypher\run1\1_11.cypher;11;x;74;2;161
.\measurementApp\cypher\run1\1_12.cypher;12;x;79;17;178
.\measurementApp\cypher\run1\1_13.cypher;13;x;80;9;187
.\measurementApp\cypher\run1\1_14.cypher;14;x;85;22;209
.\measurementApp\cypher\run1\1_15.cypher;15;x;85;6;215
.\measurementApp\cypher\run1\1_16.cypher;16;x;85;6;221
.\measurementApp\cypher\run1\1_17.cypher;17;x;80;15;236
.\measurementApp\cypher\run1\1_18.cypher;18;x;80;5;241
.\measurementApp\cypher\run1\1_19.cypher;19;x;80;4;245
.\measurementApp\cypher\run1\1_20.cypher;20;x;78;4;249
.\measurementApp\cypher\run1\1_21.cypher;21;x;79;6;255
.\measurementApp\cypher\run1\1_22.cypher;22;x;80;3;258
.\measurementApp\cypher\run1\1_23.cypher;23;x;80;1;259
.\measurementApp\cypher\run1\1_24.cypher;24;x;80;0;259
.\measurementApp\cypher\run1\1_25.cypher;25;x;79;3;262
.\measurementApp\cypher\run1\1_26.cypher;26;x;79;0;262
.\measurementApp\cypher\run1\1_27.cypher;27;x;80;2;264
.\measurementApp\cypher\run1\1_28.cypher;28;x;80;0;264
.\measurementApp\cypher\run1\1_29.cypher;29;x;78;8;272
.\measurementApp\cypher\run1\1_30.cypher;30;x;78;0;272
.\measurementApp\cypher\run1\1_31.cypher;31;x;78;0;272
.\measurementApp\cypher\run1\1_32.cypher;32;x;85;12;284
.\measurementApp\cypher\run1\1_33.cypher;33;x;78;1;285
.\measurementApp\cypher\run1\1_34.cypher;34;x;79;4;289
.\measurementApp\cypher\run1\1_35.cypher;35;x;79;2;291
.\measurementApp\cypher\run1\1_36.cypher;36;x;79;0;291
.\measurementApp\cypher\run1\1_37.cypher;37;x;79;2;293
.\measurementApp\cypher\run1\1_38.cypher;38;x;79;4;297
.\measurementApp\cypher\run1\1_39.cypher;39;x;79;0;297
.\measurementApp\cypher\run1\1_40.cypher;40;x;79;0;297
.\measurementApp\cypher\run1\1_41.cypher;41;x;79;0;297
.\measurementApp\cypher\run1\1_42.cypher;42;x;79;4;301
.\measurementApp\cypher\run1\1_43.cypher;43;x;79;2;303
.\measurementApp\cypher\run1\1_44.cypher;44;x;79;0;303
.\measurementApp\cypher\run1\1_45.cypher;45;x;79;2;305
.\measurementApp\cypher\run1\1_46.cypher;46;x;79;1;306
.\measurementApp\cypher\run1\1_47.cypher;47;x;79;0;306
.\measurementApp\cypher\run1\1_48.cypher;48;x;79;0;306
.\measurementApp\cypher\run1\1_49.cypher;49;x;79;0;306
.\measurementApp\cypher\run1\1_50.cypher;50;x;79;4;310
Model;Index;Size;InternalDiversity;NewShapes;AllCurrentShapes
.\measurementApp\cypher\run10\10_1.cypher;1;x;71;71;71
.\measurementApp\cypher\run10\10_2.cypher;2;x;72;16;87
.\measurementApp\cypher\run10\10_3.cypher;3;x;71;0;87
.\measurementApp\cypher\run10\10_4.cypher;4;x;72;9;96
.\measurementApp\cypher\run10\10_5.cypher;5;x;77;32;128
.\measurementApp\cypher\run10\10_6.cypher;6;x;78;10;138
.\measurementApp\cypher\run10\10_7.cypher;7;x;78;8;146
.\measurementApp\cypher\run10\10_8.cypher;8;x;73;7;153
.\measurementApp\cypher\run10\10_9.cypher;9;x;73;6;159
.\measurementApp\cypher\run10\10_10.cypher;10;x;75;11;170
.\measurementApp\cypher\run10\10_11.cypher;11;x;76;10;180
.\measurementApp\cypher\run10\10_12.cypher;12;x;76;0;180
.\measurementApp\cypher\run10\10_13.cypher;13;x;76;6;186
.\measurementApp\cypher\run10\10_14.cypher;14;x;75;5;191
.\measurementApp\cypher\run10\10_15.cypher;15;x;74;4;195
.\measurementApp\cypher\run10\10_16.cypher;16;x;75;6;201
.\measurementApp\cypher\run10\10_17.cypher;17;x;75;9;210
.\measurementApp\cypher\run10\10_18.cypher;18;x;75;0;210
.\measurementApp\cypher\run10\10_19.cypher;19;x;75;0;210
.\measurementApp\cypher\run10\10_20.cypher;20;x;74;0;210
.\measurementApp\cypher\run10\10_21.cypher;21;x;78;5;215
.\measurementApp\cypher\run10\10_22.cypher;22;x;74;4;219
.\measurementApp\cypher\run10\10_23.cypher;23;x;74;2;221
.\measurementApp\cypher\run10\10_24.cypher;24;x;74;0;221
.\measurementApp\cypher\run10\10_25.cypher;25;x;75;1;222
.\measurementApp\cypher\run10\10_26.cypher;26;x;78;11;233
.\measurementApp\cypher\run10\10_27.cypher;27;x;77;2;235
.\measurementApp\cypher\run10\10_28.cypher;28;x;79;0;235
.\measurementApp\cypher\run10\10_29.cypher;29;x;75;2;237
.\measurementApp\cypher\run10\10_30.cypher;30;x;76;4;241
.\measurementApp\cypher\run10\10_31.cypher;31;x;79;2;243
.\measurementApp\cypher\run10\10_32.cypher;32;x;76;0;243
.\measurementApp\cypher\run10\10_33.cypher;33;x;77;0;243
.\measurementApp\cypher\run10\10_34.cypher;34;x;79;2;245
.\measurementApp\cypher\run10\10_35.cypher;35;x;78;0;245
.\measurementApp\cypher\run10\10_36.cypher;36;x;77;0;245
.\measurementApp\cypher\run10\10_37.cypher;37;x;78;5;250
.\measurementApp\cypher\run10\10_38.cypher;38;x;76;4;254
.\measurementApp\cypher\run10\10_39.cypher;39;x;77;0;254
.\measurementApp\cypher\run10\10_40.cypher;40;x;79;0;254
.\measurementApp\cypher\run10\10_41.cypher;41;x;76;0;254
.\measurementApp\cypher\run10\10_42.cypher;42;x;77;0;254
.\measurementApp\cypher\run10\10_43.cypher;43;x;78;1;255
.\measurementApp\cypher\run10\10_44.cypher;44;x;79;0;255
.\measurementApp\cypher\run10\10_45.cypher;45;x;78;2;257
.\measurementApp\cypher\run10\10_46.cypher;46;x;74;4;261
.\measurementApp\cypher\run10\10_47.cypher;47;x;75;0;261
.\measurementApp\cypher\run10\10_48.cypher;48;x;74;0;261
.\measurementApp\cypher\run10\10_49.cypher;49;x;74;0;261
.\measurementApp\cypher\run10\10_50.cypher;50;x;75;0;261
Model;Index;Size;InternalDiversity;NewShapes;AllCurrentShapes
.\measurementApp\cypher\run2\2_1.cypher;1;x;68;68;68
.\measurementApp\cypher\run2\2_2.cypher;2;x;68;9;77
.\measurementApp\cypher\run2\2_3.cypher;3;x;68;7;84
.\measurementApp\cypher\run2\2_4.cypher;4;x;68;2;86
.\measurementApp\cypher\run2\2_5.cypher;5;x;68;4;90
.\measurementApp\cypher\run2\2_6.cypher;6;x;67;4;94
.\measurementApp\cypher\run2\2_7.cypher;7;x;68;4;98
.\measurementApp\cypher\run2\2_8.cypher;8;x;68;0;98
.\measurementApp\cypher\run2\2_9.cypher;9;x;68;0;98
.\measurementApp\cypher\run2\2_10.cypher;10;x;67;2;100
.\measurementApp\cypher\run2\2_11.cypher;11;x;70;28;128
.\measurementApp\cypher\run2\2_12.cypher;12;x;72;10;138
.\measurementApp\cypher\run2\2_13.cypher;13;x;70;6;144
.\measurementApp\cypher\run2\2_14.cypher;14;x;72;3;147
.\measurementApp\cypher\run2\2_15.cypher;15;x;70;0;147
.\measurementApp\cypher\run2\2_16.cypher;16;x;72;2;149
.\measurementApp\cypher\run2\2_17.cypher;17;x;75;20;169
.\measurementApp\cypher\run2\2_18.cypher;18;x;75;12;181
.\measurementApp\cypher\run2\2_19.cypher;19;x;70;6;187
.\measurementApp\cypher\run2\2_20.cypher;20;x;72;1;188
.\measurementApp\cypher\run2\2_21.cypher;21;x;69;3;191
.\measurementApp\cypher\run2\2_22.cypher;22;x;71;2;193
.\measurementApp\cypher\run2\2_23.cypher;23;x;74;3;196
.\measurementApp\cypher\run2\2_24.cypher;24;x;74;2;198
.\measurementApp\cypher\run2\2_25.cypher;25;x;67;7;205
.\measurementApp\cypher\run2\2_26.cypher;26;x;67;3;208
.\measurementApp\cypher\run2\2_27.cypher;27;x;68;0;208
.\measurementApp\cypher\run2\2_28.cypher;28;x;68;0;208
.\measurementApp\cypher\run2\2_29.cypher;29;x;68;0;208
.\measurementApp\cypher\run2\2_30.cypher;30;x;68;2;210
.\measurementApp\cypher\run2\2_31.cypher;31;x;68;0;210
.\measurementApp\cypher\run2\2_32.cypher;32;x;68;0;210
.\measurementApp\cypher\run2\2_33.cypher;33;x;68;0;210
.\measurementApp\cypher\run2\2_34.cypher;34;x;68;0;210
.\measurementApp\cypher\run2\2_35.cypher;35;x;68;3;213
.\measurementApp\cypher\run2\2_36.cypher;36;x;68;3;216
.\measurementApp\cypher\run2\2_37.cypher;37;x;68;4;220
.\measurementApp\cypher\run2\2_38.cypher;38;x;69;0;220
.\measurementApp\cypher\run2\2_39.cypher;39;x;69;0;220
.\measurementApp\cypher\run2\2_40.cypher;40;x;69;0;220
.\measurementApp\cypher\run2\2_41.cypher;41;x;69;2;222
.\measurementApp\cypher\run2\2_42.cypher;42;x;69;0;222
.\measurementApp\cypher\run2\2_43.cypher;43;x;68;0;222
.\measurementApp\cypher\run2\2_44.cypher;44;x;69;0;222
.\measurementApp\cypher\run2\2_45.cypher;45;x;70;3;225
.\measurementApp\cypher\run2\2_46.cypher;46;x;70;0;225
.\measurementApp\cypher\run2\2_47.cypher;47;x;70;5;230
.\measurementApp\cypher\run2\2_48.cypher;48;x;70;0;230
.\measurementApp\cypher\run2\2_49.cypher;49;x;70;0;230
.\measurementApp\cypher\run2\2_50.cypher;50;x;70;0;230
Model;Index;Size;InternalDiversity;NewShapes;AllCurrentShapes
.\measurementApp\cypher\run3\3_1.cypher;1;x;78;78;78
.\measurementApp\cypher\run3\3_2.cypher;2;x;78;11;89
.\measurementApp\cypher\run3\3_3.cypher;3;x;79;11;100
.\measurementApp\cypher\run3\3_4.cypher;4;x;80;15;115
.\measurementApp\cypher\run3\3_5.cypher;5;x;80;8;123
.\measurementApp\cypher\run3\3_6.cypher;6;x;79;10;133
.\measurementApp\cypher\run3\3_7.cypher;7;x;79;4;137
.\measurementApp\cypher\run3\3_8.cypher;8;x;79;6;143
.\measurementApp\cypher\run3\3_9.cypher;9;x;79;1;144
.\measurementApp\cypher\run3\3_10.cypher;10;x;80;9;153
.\measurementApp\cypher\run3\3_11.cypher;11;x;85;18;171
.\measurementApp\cypher\run3\3_12.cypher;12;x;85;10;181
.\measurementApp\cypher\run3\3_13.cypher;13;x;88;31;212
.\measurementApp\cypher\run3\3_14.cypher;14;x;87;8;220
.\measurementApp\cypher\run3\3_15.cypher;15;x;80;4;224
.\measurementApp\cypher\run3\3_16.cypher;16;x;80;0;224
.\measurementApp\cypher\run3\3_17.cypher;17;x;80;2;226
.\measurementApp\cypher\run3\3_18.cypher;18;x;80;0;226
.\measurementApp\cypher\run3\3_19.cypher;19;x;81;3;229
.\measurementApp\cypher\run3\3_20.cypher;20;x;81;0;229
.\measurementApp\cypher\run3\3_21.cypher;21;x;80;4;233
.\measurementApp\cypher\run3\3_22.cypher;22;x;80;1;234
.\measurementApp\cypher\run3\3_23.cypher;23;x;81;13;247
.\measurementApp\cypher\run3\3_24.cypher;24;x;81;5;252
.\measurementApp\cypher\run3\3_25.cypher;25;x;81;1;253
.\measurementApp\cypher\run3\3_26.cypher;26;x;81;0;253
.\measurementApp\cypher\run3\3_27.cypher;27;x;80;4;257
.\measurementApp\cypher\run3\3_28.cypher;28;x;80;0;257
.\measurementApp\cypher\run3\3_29.cypher;29;x;81;1;258
.\measurementApp\cypher\run3\3_30.cypher;30;x;81;1;259
.\measurementApp\cypher\run3\3_31.cypher;31;x;81;0;259
.\measurementApp\cypher\run3\3_32.cypher;32;x;80;0;259
.\measurementApp\cypher\run3\3_33.cypher;33;x;86;1;260
.\measurementApp\cypher\run3\3_34.cypher;34;x;86;0;260
.\measurementApp\cypher\run3\3_35.cypher;35;x;86;0;260
.\measurementApp\cypher\run3\3_36.cypher;36;x;86;6;266
.\measurementApp\cypher\run3\3_37.cypher;37;x;79;4;270
.\measurementApp\cypher\run3\3_38.cypher;38;x;79;0;270
.\measurementApp\cypher\run3\3_39.cypher;39;x;79;0;270
.\measurementApp\cypher\run3\3_40.cypher;40;x;80;1;271
.\measurementApp\cypher\run3\3_41.cypher;41;x;79;0;271
.\measurementApp\cypher\run3\3_42.cypher;42;x;80;13;284
.\measurementApp\cypher\run3\3_43.cypher;43;x;80;4;288
.\measurementApp\cypher\run3\3_44.cypher;44;x;81;2;290
.\measurementApp\cypher\run3\3_45.cypher;45;x;80;2;292
.\measurementApp\cypher\run3\3_46.cypher;46;x;80;2;294
.\measurementApp\cypher\run3\3_47.cypher;47;x;80;0;294
.\measurementApp\cypher\run3\3_48.cypher;48;x;81;0;294
.\measurementApp\cypher\run3\3_49.cypher;49;x;80;4;298
.\measurementApp\cypher\run3\3_50.cypher;50;x;81;2;300
Model;Index;Size;InternalDiversity;NewShapes;AllCurrentShapes
.\measurementApp\cypher\run4\4_1.cypher;1;x;68;68;68
.\measurementApp\cypher\run4\4_2.cypher;2;x;68;12;80
.\measurementApp\cypher\run4\4_3.cypher;3;x;69;7;87
.\measurementApp\cypher\run4\4_4.cypher;4;x;69;1;88
.\measurementApp\cypher\run4\4_5.cypher;5;x;69;0;88
.\measurementApp\cypher\run4\4_6.cypher;6;x;69;9;97
.\measurementApp\cypher\run4\4_7.cypher;7;x;68;4;101
.\measurementApp\cypher\run4\4_8.cypher;8;x;68;0;101
.\measurementApp\cypher\run4\4_9.cypher;9;x;68;0;101
.\measurementApp\cypher\run4\4_10.cypher;10;x;68;0;101
.\measurementApp\cypher\run4\4_11.cypher;11;x;69;4;105
.\measurementApp\cypher\run4\4_12.cypher;12;x;69;2;107
.\measurementApp\cypher\run4\4_13.cypher;13;x;68;4;111
.\measurementApp\cypher\run4\4_14.cypher;14;x;68;0;111
.\measurementApp\cypher\run4\4_15.cypher;15;x;68;0;111
.\measurementApp\cypher\run4\4_16.cypher;16;x;68;0;111
.\measurementApp\cypher\run4\4_17.cypher;17;x;69;4;115
.\measurementApp\cypher\run4\4_18.cypher;18;x;69;2;117
.\measurementApp\cypher\run4\4_19.cypher;19;x;69;0;117
.\measurementApp\cypher\run4\4_20.cypher;20;x;69;0;117
.\measurementApp\cypher\run4\4_21.cypher;21;x;69;2;119
.\measurementApp\cypher\run4\4_22.cypher;22;x;69;2;121
.\measurementApp\cypher\run4\4_23.cypher;23;x;71;17;138
.\measurementApp\cypher\run4\4_24.cypher;24;x;73;3;141
.\measurementApp\cypher\run4\4_25.cypher;25;x;71;0;141
.\measurementApp\cypher\run4\4_26.cypher;26;x;73;10;151
.\measurementApp\cypher\run4\4_27.cypher;27;x;73;9;160
.\measurementApp\cypher\run4\4_28.cypher;28;x;73;0;160
.\measurementApp\cypher\run4\4_29.cypher;29;x;72;3;163
.\measurementApp\cypher\run4\4_30.cypher;30;x;72;2;165
.\measurementApp\cypher\run4\4_31.cypher;31;x;72;6;171
.\measurementApp\cypher\run4\4_32.cypher;32;x;70;4;175
.\measurementApp\cypher\run4\4_33.cypher;33;x;71;4;179
.\measurementApp\cypher\run4\4_34.cypher;34;x;71;9;188
.\measurementApp\cypher\run4\4_35.cypher;35;x;71;0;188
.\measurementApp\cypher\run4\4_36.cypher;36;x;71;2;190
.\measurementApp\cypher\run4\4_37.cypher;37;x;70;4;194
.\measurementApp\cypher\run4\4_38.cypher;38;x;70;0;194
.\measurementApp\cypher\run4\4_39.cypher;39;x;70;1;195
.\measurementApp\cypher\run4\4_40.cypher;40;x;70;0;195
.\measurementApp\cypher\run4\4_41.cypher;41;x;71;2;197
.\measurementApp\cypher\run4\4_42.cypher;42;x;71;2;199
.\measurementApp\cypher\run4\4_43.cypher;43;x;70;3;202
.\measurementApp\cypher\run4\4_44.cypher;44;x;70;6;208
.\measurementApp\cypher\run4\4_45.cypher;45;x;71;0;208
.\measurementApp\cypher\run4\4_46.cypher;46;x;71;1;209
.\measurementApp\cypher\run4\4_47.cypher;47;x;71;0;209
.\measurementApp\cypher\run4\4_48.cypher;48;x;71;0;209
.\measurementApp\cypher\run4\4_49.cypher;49;x;71;0;209
.\measurementApp\cypher\run4\4_50.cypher;50;x;71;2;211
Model;Index;Size;InternalDiversity;NewShapes;AllCurrentShapes
.\measurementApp\cypher\run5\5_1.cypher;1;x;71;71;71
.\measurementApp\cypher\run5\5_2.cypher;2;x;69;12;83
.\measurementApp\cypher\run5\5_3.cypher;3;x;74;18;101
.\measurementApp\cypher\run5\5_4.cypher;4;x;74;12;113
.\measurementApp\cypher\run5\5_5.cypher;5;x;78;17;130
.\measurementApp\cypher\run5\5_6.cypher;6;x;78;12;142
.\measurementApp\cypher\run5\5_7.cypher;7;x;78;4;146
.\measurementApp\cypher\run5\5_8.cypher;8;x;78;12;158
.\measurementApp\cypher\run5\5_9.cypher;9;x;78;3;161
.\measurementApp\cypher\run5\5_10.cypher;10;x;78;3;164
.\measurementApp\cypher\run5\5_11.cypher;11;x;77;6;170
.\measurementApp\cypher\run5\5_12.cypher;12;x;75;7;177
.\measurementApp\cypher\run5\5_13.cypher;13;x;75;0;177
.\measurementApp\cypher\run5\5_14.cypher;14;x;75;4;181
.\measurementApp\cypher\run5\5_15.cypher;15;x;75;1;182
.\measurementApp\cypher\run5\5_16.cypher;16;x;75;0;182
.\measurementApp\cypher\run5\5_17.cypher;17;x;75;0;182
.\measurementApp\cypher\run5\5_18.cypher;18;x;75;1;183
.\measurementApp\cypher\run5\5_19.cypher;19;x;75;0;183
.\measurementApp\cypher\run5\5_20.cypher;20;x;74;4;187
.\measurementApp\cypher\run5\5_21.cypher;21;x;74;2;189
.\measurementApp\cypher\run5\5_22.cypher;22;x;75;4;193
.\measurementApp\cypher\run5\5_23.cypher;23;x;75;2;195
.\measurementApp\cypher\run5\5_24.cypher;24;x;75;4;199
.\measurementApp\cypher\run5\5_25.cypher;25;x;75;0;199
.\measurementApp\cypher\run5\5_26.cypher;26;x;75;0;199
.\measurementApp\cypher\run5\5_27.cypher;27;x;75;0;199
.\measurementApp\cypher\run5\5_28.cypher;28;x;75;0;199
.\measurementApp\cypher\run5\5_29.cypher;29;x;75;0;199
.\measurementApp\cypher\run5\5_30.cypher;30;x;75;0;199
.\measurementApp\cypher\run5\5_31.cypher;31;x;75;0;199
.\measurementApp\cypher\run5\5_32.cypher;32;x;75;0;199
.\measurementApp\cypher\run5\5_33.cypher;33;x;75;0;199
.\measurementApp\cypher\run5\5_34.cypher;34;x;75;2;201
.\measurementApp\cypher\run5\5_35.cypher;35;x;75;0;201
.\measurementApp\cypher\run5\5_36.cypher;36;x;74;2;203
.\measurementApp\cypher\run5\5_37.cypher;37;x;74;2;205
.\measurementApp\cypher\run5\5_38.cypher;38;x;74;0;205
.\measurementApp\cypher\run5\5_39.cypher;39;x;74;0;205
.\measurementApp\cypher\run5\5_40.cypher;40;x;75;2;207
.\measurementApp\cypher\run5\5_41.cypher;41;x;75;0;207
.\measurementApp\cypher\run5\5_42.cypher;42;x;76;3;210
.\measurementApp\cypher\run5\5_43.cypher;43;x;76;0;210
.\measurementApp\cypher\run5\5_44.cypher;44;x;76;0;210
.\measurementApp\cypher\run5\5_45.cypher;45;x;79;1;211
.\measurementApp\cypher\run5\5_46.cypher;46;x;76;0;211
.\measurementApp\cypher\run5\5_47.cypher;47;x;76;0;211
.\measurementApp\cypher\run5\5_48.cypher;48;x;76;0;211
.\measurementApp\cypher\run5\5_49.cypher;49;x;78;7;218
.\measurementApp\cypher\run5\5_50.cypher;50;x;76;0;218
Model;Index;Size;InternalDiversity;NewShapes;AllCurrentShapes
.\measurementApp\cypher\run6\6_1.cypher;1;x;71;71;71
.\measurementApp\cypher\run6\6_2.cypher;2;x;69;12;83
.\measurementApp\cypher\run6\6_3.cypher;3;x;74;18;101
.\measurementApp\cypher\run6\6_4.cypher;4;x;74;12;113
.\measurementApp\cypher\run6\6_5.cypher;5;x;78;27;140
.\measurementApp\cypher\run6\6_6.cypher;6;x;77;9;149
.\measurementApp\cypher\run6\6_7.cypher;7;x;78;12;161
.\measurementApp\cypher\run6\6_8.cypher;8;x;78;2;163
.\measurementApp\cypher\run6\6_9.cypher;9;x;78;2;165
.\measurementApp\cypher\run6\6_10.cypher;10;x;79;7;172
.\measurementApp\cypher\run6\6_11.cypher;11;x;79;6;178
.\measurementApp\cypher\run6\6_12.cypher;12;x;79;4;182
.\measurementApp\cypher\run6\6_13.cypher;13;x;79;2;184
.\measurementApp\cypher\run6\6_14.cypher;14;x;78;4;188
.\measurementApp\cypher\run6\6_15.cypher;15;x;78;0;188
.\measurementApp\cypher\run6\6_16.cypher;16;x;79;4;192
.\measurementApp\cypher\run6\6_17.cypher;17;x;79;0;192
.\measurementApp\cypher\run6\6_18.cypher;18;x;79;4;196
.\measurementApp\cypher\run6\6_19.cypher;19;x;79;2;198
.\measurementApp\cypher\run6\6_20.cypher;20;x;75;0;198
.\measurementApp\cypher\run6\6_21.cypher;21;x;75;3;201
.\measurementApp\cypher\run6\6_22.cypher;22;x;75;0;201
.\measurementApp\cypher\run6\6_23.cypher;23;x;75;2;203
.\measurementApp\cypher\run6\6_24.cypher;24;x;75;2;205
.\measurementApp\cypher\run6\6_25.cypher;25;x;75;2;207
.\measurementApp\cypher\run6\6_26.cypher;26;x;75;0;207
.\measurementApp\cypher\run6\6_27.cypher;27;x;75;2;209
.\measurementApp\cypher\run6\6_28.cypher;28;x;74;0;209
.\measurementApp\cypher\run6\6_29.cypher;29;x;74;0;209
.\measurementApp\cypher\run6\6_30.cypher;30;x;74;0;209
.\measurementApp\cypher\run6\6_31.cypher;31;x;74;0;209
.\measurementApp\cypher\run6\6_32.cypher;32;x;75;1;210
.\measurementApp\cypher\run6\6_33.cypher;33;x;75;0;210
.\measurementApp\cypher\run6\6_34.cypher;34;x;75;1;211
.\measurementApp\cypher\run6\6_35.cypher;35;x;75;0;211
.\measurementApp\cypher\run6\6_36.cypher;36;x;75;0;211
.\measurementApp\cypher\run6\6_37.cypher;37;x;75;0;211
.\measurementApp\cypher\run6\6_38.cypher;38;x;75;1;212
.\measurementApp\cypher\run6\6_39.cypher;39;x;75;0;212
.\measurementApp\cypher\run6\6_40.cypher;40;x;79;0;212
.\measurementApp\cypher\run6\6_41.cypher;41;x;79;7;219
.\measurementApp\cypher\run6\6_42.cypher;42;x;79;0;219
.\measurementApp\cypher\run6\6_43.cypher;43;x;79;0;219
.\measurementApp\cypher\run6\6_44.cypher;44;x;79;5;224
.\measurementApp\cypher\run6\6_45.cypher;45;x;80;0;224
.\measurementApp\cypher\run6\6_46.cypher;46;x;80;0;224
.\measurementApp\cypher\run6\6_47.cypher;47;x;80;0;224
.\measurementApp\cypher\run6\6_48.cypher;48;x;80;0;224
.\measurementApp\cypher\run6\6_49.cypher;49;x;79;0;224
.\measurementApp\cypher\run6\6_50.cypher;50;x;79;0;224
Model;Index;Size;InternalDiversity;NewShapes;AllCurrentShapes
.\measurementApp\cypher\run7\7_1.cypher;1;x;77;77;77
.\measurementApp\cypher\run7\7_2.cypher;2;x;78;32;109
.\measurementApp\cypher\run7\7_3.cypher;3;x;79;11;120
.\measurementApp\cypher\run7\7_4.cypher;4;x;79;9;129
.\measurementApp\cypher\run7\7_5.cypher;5;x;80;16;145
.\measurementApp\cypher\run7\7_6.cypher;6;x;79;8;153
.\measurementApp\cypher\run7\7_7.cypher;7;x;80;3;156
.\measurementApp\cypher\run7\7_8.cypher;8;x;80;4;160
.\measurementApp\cypher\run7\7_9.cypher;9;x;79;14;174
.\measurementApp\cypher\run7\7_10.cypher;10;x;79;0;174
.\measurementApp\cypher\run7\7_11.cypher;11;x;79;0;174
.\measurementApp\cypher\run7\7_12.cypher;12;x;79;0;174
.\measurementApp\cypher\run7\7_13.cypher;13;x;78;4;178
.\measurementApp\cypher\run7\7_14.cypher;14;x;78;6;184
.\measurementApp\cypher\run7\7_15.cypher;15;x;78;0;184
.\measurementApp\cypher\run7\7_16.cypher;16;x;78;6;190
.\measurementApp\cypher\run7\7_17.cypher;17;x;81;8;198
.\measurementApp\cypher\run7\7_18.cypher;18;x;81;0;198
.\measurementApp\cypher\run7\7_19.cypher;19;x;81;6;204
.\measurementApp\cypher\run7\7_20.cypher;20;x;81;4;208
.\measurementApp\cypher\run7\7_21.cypher;21;x;81;0;208
.\measurementApp\cypher\run7\7_22.cypher;22;x;81;0;208
.\measurementApp\cypher\run7\7_23.cypher;23;x;78;4;212
.\measurementApp\cypher\run7\7_24.cypher;24;x;78;2;214
.\measurementApp\cypher\run7\7_25.cypher;25;x;77;4;218
.\measurementApp\cypher\run7\7_26.cypher;26;x;77;0;218
.\measurementApp\cypher\run7\7_27.cypher;27;x;77;0;218
.\measurementApp\cypher\run7\7_28.cypher;28;x;77;0;218
.\measurementApp\cypher\run7\7_29.cypher;29;x;79;4;222
.\measurementApp\cypher\run7\7_30.cypher;30;x;79;0;222
.\measurementApp\cypher\run7\7_31.cypher;31;x;78;1;223
.\measurementApp\cypher\run7\7_32.cypher;32;x;78;0;223
.\measurementApp\cypher\run7\7_33.cypher;33;x;78;0;223
.\measurementApp\cypher\run7\7_34.cypher;34;x;78;4;227
.\measurementApp\cypher\run7\7_35.cypher;35;x;79;4;231
.\measurementApp\cypher\run7\7_36.cypher;36;x;79;2;233
.\measurementApp\cypher\run7\7_37.cypher;37;x;79;4;237
.\measurementApp\cypher\run7\7_38.cypher;38;x;78;2;239
.\measurementApp\cypher\run7\7_39.cypher;39;x;86;10;249
.\measurementApp\cypher\run7\7_40.cypher;40;x;86;7;256
.\measurementApp\cypher\run7\7_41.cypher;41;x;86;7;263
.\measurementApp\cypher\run7\7_42.cypher;42;x;86;0;263
.\measurementApp\cypher\run7\7_43.cypher;43;x;86;4;267
.\measurementApp\cypher\run7\7_44.cypher;44;x;86;0;267
.\measurementApp\cypher\run7\7_45.cypher;45;x;87;1;268
.\measurementApp\cypher\run7\7_46.cypher;46;x;87;0;268
.\measurementApp\cypher\run7\7_47.cypher;47;x;86;4;272
.\measurementApp\cypher\run7\7_48.cypher;48;x;87;1;273
.\measurementApp\cypher\run7\7_49.cypher;49;x;87;2;275
.\measurementApp\cypher\run7\7_50.cypher;50;x;87;2;277
Model;Index;Size;InternalDiversity;NewShapes;AllCurrentShapes
.\measurementApp\cypher\run8\8_1.cypher;1;x;75;75;75
.\measurementApp\cypher\run8\8_2.cypher;2;x;75;9;84
.\measurementApp\cypher\run8\8_3.cypher;3;x;77;15;99
.\measurementApp\cypher\run8\8_4.cypher;4;x;77;0;99
.\measurementApp\cypher\run8\8_5.cypher;5;x;79;18;117
.\measurementApp\cypher\run8\8_6.cypher;6;x;79;3;120
.\measurementApp\cypher\run8\8_7.cypher;7;x;80;1;121
.\measurementApp\cypher\run8\8_8.cypher;8;x;80;9;130
.\measurementApp\cypher\run8\8_9.cypher;9;x;79;0;130
.\measurementApp\cypher\run8\8_10.cypher;10;x;80;12;142
.\measurementApp\cypher\run8\8_11.cypher;11;x;79;28;170
.\measurementApp\cypher\run8\8_12.cypher;12;x;79;9;179
.\measurementApp\cypher\run8\8_13.cypher;13;x;80;12;191
.\measurementApp\cypher\run8\8_14.cypher;14;x;85;11;202
.\measurementApp\cypher\run8\8_15.cypher;15;x;85;10;212
.\measurementApp\cypher\run8\8_16.cypher;16;x;85;8;220
.\measurementApp\cypher\run8\8_17.cypher;17;x;85;5;225
.\measurementApp\cypher\run8\8_18.cypher;18;x;85;2;227
.\measurementApp\cypher\run8\8_19.cypher;19;x;85;1;228
.\measurementApp\cypher\run8\8_20.cypher;20;x;83;4;232
.\measurementApp\cypher\run8\8_21.cypher;21;x;85;3;235
.\measurementApp\cypher\run8\8_22.cypher;22;x;83;0;235
.\measurementApp\cypher\run8\8_23.cypher;23;x;85;1;236
.\measurementApp\cypher\run8\8_24.cypher;24;x;83;1;237
.\measurementApp\cypher\run8\8_25.cypher;25;x;83;0;237
.\measurementApp\cypher\run8\8_26.cypher;26;x;83;0;237
.\measurementApp\cypher\run8\8_27.cypher;27;x;83;0;237
.\measurementApp\cypher\run8\8_28.cypher;28;x;80;7;244
.\measurementApp\cypher\run8\8_29.cypher;29;x;81;0;244
.\measurementApp\cypher\run8\8_30.cypher;30;x;80;0;244
.\measurementApp\cypher\run8\8_31.cypher;31;x;81;0;244
.\measurementApp\cypher\run8\8_32.cypher;32;x;87;18;262
.\measurementApp\cypher\run8\8_33.cypher;33;x;87;5;267
.\measurementApp\cypher\run8\8_34.cypher;34;x;80;4;271
.\measurementApp\cypher\run8\8_35.cypher;35;x;80;2;273
.\measurementApp\cypher\run8\8_36.cypher;36;x;81;0;273
.\measurementApp\cypher\run8\8_37.cypher;37;x;81;2;275
.\measurementApp\cypher\run8\8_38.cypher;38;x;81;4;279
.\measurementApp\cypher\run8\8_39.cypher;39;x;81;2;281
.\measurementApp\cypher\run8\8_40.cypher;40;x;79;4;285
.\measurementApp\cypher\run8\8_41.cypher;41;x;79;0;285
.\measurementApp\cypher\run8\8_42.cypher;42;x;80;0;285
.\measurementApp\cypher\run8\8_43.cypher;43;x;80;0;285
.\measurementApp\cypher\run8\8_44.cypher;44;x;80;11;296
.\measurementApp\cypher\run8\8_45.cypher;45;x;80;2;298
.\measurementApp\cypher\run8\8_46.cypher;46;x;80;4;302
.\measurementApp\cypher\run8\8_47.cypher;47;x;80;0;302
.\measurementApp\cypher\run8\8_48.cypher;48;x;81;7;309
.\measurementApp\cypher\run8\8_49.cypher;49;x;81;0;309
.\measurementApp\cypher\run8\8_50.cypher;50;x;80;2;311
Model;Index;Size;InternalDiversity;NewShapes;AllCurrentShapes
.\measurementApp\cypher\run9\9_1.cypher;1;x;71;71;71
.\measurementApp\cypher\run9\9_2.cypher;2;x;71;9;80
.\measurementApp\cypher\run9\9_3.cypher;3;x;74;25;105
.\measurementApp\cypher\run9\9_4.cypher;4;x;75;7;112
.\measurementApp\cypher\run9\9_5.cypher;5;x;75;12;124
.\measurementApp\cypher\run9\9_6.cypher;6;x;75;9;133
.\measurementApp\cypher\run9\9_7.cypher;7;x;78;11;144
.\measurementApp\cypher\run9\9_8.cypher;8;x;78;6;150
.\measurementApp\cypher\run9\9_9.cypher;9;x;75;0;150
.\measurementApp\cypher\run9\9_10.cypher;10;x;78;9;159
.\measurementApp\cypher\run9\9_11.cypher;11;x;75;4;163
.\measurementApp\cypher\run9\9_12.cypher;12;x;75;0;163
.\measurementApp\cypher\run9\9_13.cypher;13;x;75;0;163
.\measurementApp\cypher\run9\9_14.cypher;14;x;75;0;163
.\measurementApp\cypher\run9\9_15.cypher;15;x;75;4;167
.\measurementApp\cypher\run9\9_16.cypher;16;x;75;0;167
.\measurementApp\cypher\run9\9_17.cypher;17;x;75;0;167
.\measurementApp\cypher\run9\9_18.cypher;18;x;75;0;167
.\measurementApp\cypher\run9\9_19.cypher;19;x;74;4;171
.\measurementApp\cypher\run9\9_20.cypher;20;x;74;0;171
.\measurementApp\cypher\run9\9_21.cypher;21;x;75;4;175
.\measurementApp\cypher\run9\9_22.cypher;22;x;75;2;177
.\measurementApp\cypher\run9\9_23.cypher;23;x;75;2;179
.\measurementApp\cypher\run9\9_24.cypher;24;x;75;0;179
.\measurementApp\cypher\run9\9_25.cypher;25;x;74;1;180
.\measurementApp\cypher\run9\9_26.cypher;26;x;74;0;180
.\measurementApp\cypher\run9\9_27.cypher;27;x;79;9;189
.\measurementApp\cypher\run9\9_28.cypher;28;x;79;2;191
.\measurementApp\cypher\run9\9_29.cypher;29;x;79;0;191
.\measurementApp\cypher\run9\9_30.cypher;30;x;78;8;199
.\measurementApp\cypher\run9\9_31.cypher;31;x;79;0;199
.\measurementApp\cypher\run9\9_32.cypher;32;x;78;7;206
.\measurementApp\cypher\run9\9_33.cypher;33;x;80;4;210
.\measurementApp\cypher\run9\9_34.cypher;34;x;79;0;210
.\measurementApp\cypher\run9\9_35.cypher;35;x;80;0;210
.\measurementApp\cypher\run9\9_36.cypher;36;x;79;7;217
.\measurementApp\cypher\run9\9_37.cypher;37;x;79;4;221
.\measurementApp\cypher\run9\9_38.cypher;38;x;79;2;223
.\measurementApp\cypher\run9\9_39.cypher;39;x;78;0;223
.\measurementApp\cypher\run9\9_40.cypher;40;x;78;2;225
.\measurementApp\cypher\run9\9_41.cypher;41;x;80;2;227
.\measurementApp\cypher\run9\9_42.cypher;42;x;79;0;227
.\measurementApp\cypher\run9\9_43.cypher;43;x;80;0;227
.\measurementApp\cypher\run9\9_44.cypher;44;x;79;2;229
.\measurementApp\cypher\run9\9_45.cypher;45;x;80;1;230
.\measurementApp\cypher\run9\9_46.cypher;46;x;79;1;231
.\measurementApp\cypher\run9\9_47.cypher;47;x;80;0;231
.\measurementApp\cypher\run9\9_48.cypher;48;x;79;0;231
.\measurementApp\cypher\run9\9_49.cypher;49;x;79;1;232
.\measurementApp\cypher\run9\9_50.cypher;50;x;78;1;233
